,NAME_3,NAME_2,NAME_1,avg,count,id,pop,m,f
0,Bakam,Bangka,BangkaBelitung,78.05088496,452,1,35279,17639,17640
1,Belinyu,Bangka,BangkaBelitung,85.45683453,556,2,47514,23757,23757
2,MendoBarat,Bangka,BangkaBelitung,86.1503876,645,3,55567,27783,27784
3,Merawang,Bangka,BangkaBelitung,68.09543568,241,4,16411,8205,8206
4,Pemali,Bangka,BangkaBelitung,100.1007194,139,5,13914,6957,6957
5,PudingBesar,Bangka,BangkaBelitung,70.71104816,353,6,24961,12480,12481
6,RiauSilip,Bangka,BangkaBelitung,42.97354497,567,7,24366,12183,12183
7,SungaiLiat,Bangka,BangkaBelitung,426.880597,134,8,57202,28601,28601
8,Jebus,BangkaBarat,BangkaBelitung,66.90443213,722,9,48305,24152,24153
9,Kelapa,BangkaBarat,BangkaBelitung,78.91210614,603,10,47584,23792,23792
10,Mentok,BangkaBarat,BangkaBelitung,57.21372032,379,11,21684,10842,10842
11,SimpangTeritip,BangkaBarat,BangkaBelitung,59.75419664,834,12,49835,24917,24918
12,Tempilang,BangkaBarat,BangkaBelitung,72.49734043,376,13,27259,13629,13630
13,AirGegas,BangkaSelatan,BangkaBelitung,66.06621227,1027,14,67850,33925,33925
14,LeparPongok,BangkaSelatan,BangkaBelitung,35.01438849,278,15,9734,4867,4867
15,Payung,BangkaSelatan,BangkaBelitung,93.18781726,394,16,36716,18358,18358
16,PulauBesar,BangkaSelatan,BangkaBelitung,31.76608187,342,17,10864,5432,5432
17,SimpangRimba,BangkaSelatan,BangkaBelitung,78.58098592,568,18,44634,22317,22317
18,Toboali,BangkaSelatan,BangkaBelitung,82.56359102,802,19,66216,33108,33108
19,TukakSadai,BangkaSelatan,BangkaBelitung,26.58222222,225,20,5981,2990,2991
20,Koba,BangkaTengah,BangkaBelitung,103.9423631,347,21,36068,18034,18034
21,LubukBesar,BangkaTengah,BangkaBelitung,53.36889693,553,22,29513,14756,14757
22,Namang,BangkaTengah,BangkaBelitung,44.99029126,206,23,9268,4634,4634
23,PangkalanBaru,BangkaTengah,BangkaBelitung,96.37962963,108,24,10409,5204,5205
24,SimpangKatis,BangkaTengah,BangkaBelitung,112.9391304,230,25,25976,12988,12988
25,SungaiSelan,BangkaTengah,BangkaBelitung,74.54,800,26,59632,29816,29816
26,Badau,Belitung,BangkaBelitung,26.4692623,488,27,12917,6458,6459
27,Membalong,Belitung,BangkaBelitung,22.70641283,998,28,22661,11330,11331
28,SelatNasik,Belitung,BangkaBelitung,2.145348837,172,29,369,184,185
29,Sijuk,Belitung,BangkaBelitung,44.93852459,488,30,21930,10965,10965
30,TanjungPandan,Belitung,BangkaBelitung,447.9333333,180,31,80628,40314,40314
31,Damar,BelitungTimur,BangkaBelitung,12.64748201,278,32,3516,1758,1758
32,Dendang,BelitungTimur,BangkaBelitung,17.51070336,327,33,5726,2863,2863
33,Gantung,BelitungTimur,BangkaBelitung,38.74257426,606,34,23478,11739,11739
34,KelapaKampit,BelitungTimur,BangkaBelitung,48.32882012,517,35,24986,12493,12493
35,Manggar,BelitungTimur,BangkaBelitung,32.92715232,151,36,4972,2486,2486
36,SimpangPesak,BelitungTimur,BangkaBelitung,45.76209677,248,37,11349,5674,5675
37,SimpangRenggiang,BelitungTimur,BangkaBelitung,30.76614699,449,38,13814,6907,6907
38,BukitIntan,Pangkalpinang,BangkaBelitung,382.2325581,43,39,16436,8218,8218
39,Gerunggang,Pangkalpinang,BangkaBelitung,452.6875,32,40,14486,7243,7243
40,PangkalBalam,Pangkalpinang,BangkaBelitung,820.3846154,26,41,21330,10665,10665
41,Rangkui,Pangkalpinang,BangkaBelitung,5848,8,42,46784,23392,23392
42,TamanSari,Pangkalpinang,BangkaBelitung,4963.5,2,43,9927,4963,4964
43,Cibeber,Cilegon,Banten,2392.1,20,44,47842,23921,23921
44,Cilegon,Cilegon,Banten,2665.2,10,45,26652,13326,13326
45,Citangkil,Cilegon,Banten,3077.5,26,46,80015,40007,40008
46,Ciwandan,Cilegon,Banten,1667.787879,33,47,55037,27518,27519
47,Grogol,Cilegon,Banten,2199,25,48,54975,27487,27488
48,Jombang,Cilegon,Banten,4044.909091,11,49,44494,22247,22247
49,Pulomerak,Cilegon,Banten,1419.444444,27,50,38325,19162,19163
50,Purwakarta,Cilegon,Banten,2736.45,20,51,54729,27364,27365
51,CipocokJaya,KotaSerang,Banten,1564.171429,35,52,54746,27373,27373
52,Curug,KotaSerang,Banten,1009.815789,38,53,38373,19186,19187
53,Kasemen,KotaSerang,Banten,1350.594203,69,54,93191,46595,46596
54,Serang,KotaSerang,Banten,5362.851852,27,55,144797,72398,72399
55,Taktakan,KotaSerang,Banten,1186.35,60,56,71181,35590,35591
56,Walantaka,KotaSerang,Banten,2277.638889,36,57,81995,40997,40998
57,Batuceper,KotaTangerang,Banten,3472.75,8,58,27782,13891,13891
58,Benda,KotaTangerang,Banten,1394.827586,29,59,40450,20225,20225
59,Cibodas,KotaTangerang,Banten,24727.88889,9,60,222551,111275,111276
60,Ciledug,KotaTangerang,Banten,6048.8,10,61,60488,30244,30244
61,Cipondoh,KotaTangerang,Banten,3622.894737,19,62,68835,34417,34418
62,Jatiuwung,KotaTangerang,Banten,3234.625,16,63,51754,25877,25877
63,KarangTengah,KotaTangerang,Banten,6398.9,10,64,63989,31994,31995
64,Karawaci,KotaTangerang,Banten,25186.38462,13,65,327423,163711,163712
65,Larangan,KotaTangerang,Banten,9276.333333,9,66,83487,41743,41744
66,Neglasari,KotaTangerang,Banten,7702.266667,15,67,115534,57767,57767
67,Periuk,KotaTangerang,Banten,7530.75,12,68,90369,45184,45185
68,Pinang,KotaTangerang,Banten,4903.363636,22,69,107874,53937,53937
69,Tangerang,KotaTangerang,Banten,18941.75,16,70,303068,151534,151534
70,Banjarsari,Lebak,Banten,360.5789474,152,71,54808,27404,27404
71,Bayah,Lebak,Banten,465.6,150,72,69840,34920,34920
72,Bojongmanik,Lebak,Banten,123.5612245,98,73,12109,6054,6055
73,Cibadak,Lebak,Banten,2712,36,74,97632,48816,48816
74,Cibeber,Lebak,Banten,74.27819549,399,75,29637,14818,14819
75,Cigemblong,Lebak,Banten,67.97468354,158,76,10740,5370,5370
76,Cihara,Lebak,Banten,212.8267717,127,77,27029,13514,13515
77,Cijaku,Lebak,Banten,247.0183486,109,78,26925,13462,13463
78,Cikulur,Lebak,Banten,356.1111111,63,79,22435,11217,11218
79,Cileles,Lebak,Banten,159.7261905,168,80,26834,13417,13417
80,Cilograng,Lebak,Banten,117.5578947,95,81,11168,5584,5584
81,Cimarga,Lebak,Banten,111.1122995,187,82,20778,10389,10389
82,Cipanas,Lebak,Banten,124.234375,64,83,7951,3975,3976
83,Cirinten,Lebak,Banten,132.752,125,84,16594,8297,8297
84,Curugbitung,Lebak,Banten,361.6808511,94,85,33998,16999,16999
85,Gunungkencana,Lebak,Banten,140.5815603,141,86,19822,9911,9911
86,Kalanganyar,Lebak,Banten,1516.266667,30,87,45488,22744,22744
87,Lebakgedong,Lebak,Banten,37.76842105,95,88,3588,1794,1794
88,Leuwidamar,Lebak,Banten,115.4827586,145,89,16745,8372,8373
89,Maja,Lebak,Banten,1251.315789,76,90,95100,47550,47550
90,Malingping,Lebak,Banten,898.1559633,109,91,97899,48949,48950
91,Muncang,Lebak,Banten,47.88095238,84,92,4022,2011,2011
92,Panggarangan,Lebak,Banten,189.8324022,179,93,33980,16990,16990
93,Rangkasbitung,Lebak,Banten,3340.013158,76,94,253841,126920,126921
94,Sajira,Lebak,Banten,408.4716981,106,95,43298,21649,21649
95,Sobang,Lebak,Banten,112.4621849,119,96,13383,6691,6692
96,Wanasalam,Lebak,Banten,770.5932203,118,97,90930,45465,45465
97,Warunggunung,Lebak,Banten,756.877551,49,98,37087,18543,18544
98,Angsana,Pandeglang,Banten,589.5111111,90,99,53056,26528,26528
99,Banjar,Pandeglang,Banten,755.516129,31,100,23421,11710,11711
100,Bojong,Pandeglang,Banten,732.326087,46,101,33687,16843,16844
101,Cadasari,Pandeglang,Banten,460.0645161,31,102,14262,7131,7131
102,Carita,Pandeglang,Banten,400.8714286,70,103,28061,14030,14031
103,Cibaliung,Pandeglang,Banten,410.5267857,112,104,45979,22989,22990
104,Cibitung,Pandeglang,Banten,370.9243697,119,105,44140,22070,22070
105,Cigeulis,Pandeglang,Banten,254.1955307,179,106,45501,22750,22751
106,Cikedal,Pandeglang,Banten,1073.125,24,107,25755,12877,12878
107,Cikeusik,Pandeglang,Banten,781.7630332,211,108,164952,82476,82476
108,Cimanggu,Pandeglang,Banten,286.6875,160,109,45870,22935,22935
109,Cimanuk,Pandeglang,Banten,1040.958333,24,110,24983,12491,12492
110,Cipeucang,Pandeglang,Banten,796.7142857,28,111,22308,11154,11154
111,Cisata,Pandeglang,Banten,705,31,112,21855,10927,10928
112,Jiput,Pandeglang,Banten,439.6724138,58,113,25501,12750,12751
113,Kaduhejo,Pandeglang,Banten,804.0810811,37,114,29751,14875,14876
114,Karangtanjung,Pandeglang,Banten,1224.545455,22,115,26940,13470,13470
115,Koroncong,Pandeglang,Banten,767.0526316,19,116,14574,7287,7287
116,Labuan,Pandeglang,Banten,2226.764706,17,117,37855,18927,18928
117,Majasari,Pandeglang,Banten,1840.714286,21,118,38655,19327,19328
118,Mandalawangi,Pandeglang,Banten,522.8674699,83,119,43398,21699,21699
119,Mekarjaya,Pandeglang,Banten,588.9032258,31,120,18256,9128,9128
120,Menes,Pandeglang,Banten,1373.545455,22,121,30218,15109,15109
121,Munjul,Pandeglang,Banten,421.4936709,79,122,33298,16649,16649
122,Pagelaran,Pandeglang,Banten,848.8085106,47,123,39894,19947,19947
123,Pandeglang,Pandeglang,Banten,1942.375,16,124,31078,15539,15539
124,Panimbang,Pandeglang,Banten,581.7264151,106,125,61663,30831,30832
125,Patia,Pandeglang,Banten,592.4693878,49,126,29031,14515,14516
126,Picung,Pandeglang,Banten,689.2592593,54,127,37220,18610,18610
127,Pulosari,Pandeglang,Banten,647.7631579,38,128,24615,12307,12308
128,Saketi,Pandeglang,Banten,671.4210526,57,129,38271,19135,19136
129,Sindangresmi,Pandeglang,Banten,438.7936508,63,130,27644,13822,13822
130,Sobang,Pandeglang,Banten,591.6131387,137,131,81051,40525,40526
131,Sukaresmi,Pandeglang,Banten,682.94,50,132,34147,17073,17074
132,Sumur,Pandeglang,Banten,52.68404908,652,133,34350,17175,17175
133,Anyar,Serang,Banten,1072.733333,60,134,64364,32182,32182
134,Bandung,Serang,Banten,826.24,25,135,20656,10328,10328
135,Baros,Serang,Banten,616.7105263,38,136,23435,11717,11718
136,Binuang,Serang,Banten,1889.533333,30,137,56686,28343,28343
137,Bojonegara,Serang,Banten,1857,32,138,59424,29712,29712
138,Carenang,Serang,Banten,1928.257143,35,139,67489,33744,33745
139,Cikande,Serang,Banten,3205.130435,46,140,147436,73718,73718
140,Cikeusal,Serang,Banten,1223.949153,59,141,72213,36106,36107
141,Cinangka,Serang,Banten,548.128,125,142,68516,34258,34258
142,Ciomas,Serang,Banten,187.3571429,56,143,10492,5246,5246
143,Ciruas,Serang,Banten,2216.955556,45,144,99763,49881,49882
144,Gunungsari,Serang,Banten,69.53846154,52,145,3616,1808,1808
145,Jawilan,Serang,Banten,2292.75,44,146,100881,50440,50441
146,Kibin,Serang,Banten,2873.96875,32,147,91967,45983,45984
147,Kopo,Serang,Banten,2089.275,40,148,83571,41785,41786
148,Kragilan,Serang,Banten,2604.571429,42,149,109392,54696,54696
149,Kramatwatu,Serang,Banten,2356.886792,53,150,124915,62457,62458
150,Mancak,Serang,Banten,256.85,100,151,25685,12842,12843
151,Pabuaran,Serang,Banten,333.7804878,41,152,13685,6842,6843
152,Padarincang,Serang,Banten,324.2871287,101,153,32753,16376,16377
153,Pamarayan,Serang,Banten,1578.833333,48,154,75784,37892,37892
154,Petir,Serang,Banten,738.8571429,49,155,36204,18102,18102
155,Pontang,Serang,Banten,974.0375,80,156,77923,38961,38962
156,Puloampel,Serang,Banten,972.8888889,45,157,43780,21890,21890
157,Tanara,Serang,Banten,877.3555556,45,158,39481,19740,19741
158,Tirtayasa,Serang,Banten,810.6190476,63,159,51069,25534,25535
159,Tunjungteja,Serang,Banten,1144.27907,43,160,49204,24602,24602
160,Waringinkurung,Serang,Banten,359.3695652,46,161,16531,8265,8266
161,Balaraja,Tangerang,Banten,4490.354839,31,162,139201,69600,69601
162,Cikupa,Tangerang,Banten,3999.886364,44,163,175995,87997,87998
163,Cisauk,Tangerang,Banten,3551.285714,28,164,99436,49718,49718
164,Cisoka,Tangerang,Banten,3224.030303,33,165,106393,53196,53197
165,Curug,Tangerang,Banten,5057.9,30,166,151737,75868,75869
166,GunungKaler,Tangerang,Banten,2019.935484,31,167,62618,31309,31309
167,Jambe,Tangerang,Banten,1814.892857,28,168,50817,25408,25409
168,Jayanti,Tangerang,Banten,2838.043478,23,169,65275,32637,32638
169,KelapaDua,Tangerang,Banten,7990.68,25,170,199767,99883,99884
170,Kemiri,Tangerang,Banten,1380.444444,36,171,49696,24848,24848
171,Kosambi,Tangerang,Banten,2503.617647,34,172,85123,42561,42562
172,Kresek,Tangerang,Banten,2514.3125,32,173,80458,40229,40229
173,Kronjo,Tangerang,Banten,1916.212766,47,174,90062,45031,45031
174,Legok,Tangerang,Banten,3371.783784,37,175,124756,62378,62378
175,Mauk,Tangerang,Banten,1847.354167,48,176,88673,44336,44337
176,Mekarbaru,Tangerang,Banten,1993.83871,31,177,61809,30904,30905
177,Pagedangan,Tangerang,Banten,3594.425926,54,178,194099,97049,97050
178,Pakuhaji,Tangerang,Banten,2075.086207,58,179,120355,60177,60178
179,Panongan,Tangerang,Banten,2598.195122,41,180,106526,53263,53263
180,PasarKemis,Tangerang,Banten,5471.096774,31,181,169604,84802,84802
181,Rajeg,Tangerang,Banten,2740.117647,51,182,139746,69873,69873
182,Sepatan,Tangerang,Banten,5454.619048,21,183,114547,57273,57274
183,SepatanTimur,Tangerang,Banten,4563.470588,17,184,77579,38789,38790
184,SindangJaya,Tangerang,Banten,2345.902439,41,185,96182,48091,48091
185,Solear,Tangerang,Banten,3164.314286,35,186,110751,55375,55376
186,Sukadiri,Tangerang,Banten,2232.708333,24,187,53585,26792,26793
187,Sukamulya,Tangerang,Banten,2839.5,26,188,73827,36913,36914
188,Teluknaga,Tangerang,Banten,1308.45098,51,189,66731,33365,33366
189,Tigaraksa,Tangerang,Banten,3024.826923,52,190,157291,78645,78646
190,Ciputat,TangerangSelatan,Banten,4342.315789,19,191,82504,41252,41252
191,CiputatTimur,TangerangSelatan,Banten,10815.84211,19,192,205501,102750,102751
192,Pamulang,TangerangSelatan,Banten,6437.3,30,193,193119,96559,96560
193,PondokAren,TangerangSelatan,Banten,4401.833333,30,194,132055,66027,66028
194,Serpong,TangerangSelatan,Banten,5601.241379,29,195,162436,81218,81218
195,SerpongUtara,TangerangSelatan,Banten,6682.52381,21,196,140333,70166,70167
196,Setu,TangerangSelatan,Banten,5663.421053,19,197,107605,53802,53803
197,GadingCempaka,Bengkulu,Bengkulu,4478.625,16,198,71658,35829,35829
198,KampungMelayu,Bengkulu,Bengkulu,882.0869565,46,199,40576,20288,20288
199,MuaraBangkaHulu,Bengkulu,Bengkulu,776.7954545,44,200,34179,17089,17090
200,RatuAgung,Bengkulu,Bengkulu,10202.25,8,201,81618,40809,40809
201,RatuSamban,Bengkulu,Bengkulu,14888.25,4,202,59553,29776,29777
202,Selebar,Bengkulu,Bengkulu,1255.54717,53,203,66544,33272,33272
203,SungaiSerut,Bengkulu,Bengkulu,1533.05,20,204,30661,15330,15331
204,TelukSegara,Bengkulu,Bengkulu,20538.33333,3,205,61615,30807,30808
205,AirNipis,BengkuluSelatan,Bengkulu,5.91943128,211,206,1249,624,625
206,BungaMas,BengkuluSelatan,Bengkulu,58.5,42,207,2457,1228,1229
207,Kedurang,BengkuluSelatan,Bengkulu,17.55454545,220,208,3862,1931,1931
208,KedurangIlir,BengkuluSelatan,Bengkulu,33.67307692,52,209,1751,875,876
209,KotaManna,BengkuluSelatan,Bengkulu,870.0967742,31,210,26973,13486,13487
210,Manna,BengkuluSelatan,Bengkulu,141.6,35,211,4956,2478,2478
211,PasarManna,BengkuluSelatan,Bengkulu,2519.75,8,212,20158,10079,10079
212,Pino,BengkuluSelatan,Bengkulu,41.50704225,71,213,2947,1473,1474
213,Pinoraya,BengkuluSelatan,Bengkulu,38.14285714,273,214,10413,5206,5207
214,Seginim,BengkuluSelatan,Bengkulu,102.6545455,55,215,5646,2823,2823
215,UluManna,BengkuluSelatan,Bengkulu,29.50632911,237,216,6993,3496,3497
216,BangHaji,BengkuluTengah,Bengkulu,58.94444444,72,217,4244,2122,2122
217,KarangTinggi,BengkuluTengah,Bengkulu,57.91145833,192,218,11119,5559,5560
218,Lahan,BengkuluTengah,Bengkulu,8.894736842,95,219,845,422,423
219,MerigiKelindang,BengkuluTengah,Bengkulu,38.88392857,112,220,4355,2177,2178
220,MerigiSakti,BengkuluTengah,Bengkulu,29.10606061,66,221,1921,960,961
221,PagarJati,BengkuluTengah,Bengkulu,24.76119403,67,222,1659,829,830
222,PematangTiga,BengkuluTengah,Bengkulu,71.22535211,71,223,5057,2528,2529
223,PondokKelapa,BengkuluTengah,Bengkulu,126.0175439,114,224,14366,7183,7183
224,PondokKubang,BengkuluTengah,Bengkulu,91.65,80,225,7332,3666,3666
225,TabaPenanjung,BengkuluTengah,Bengkulu,23.55660377,106,226,2497,1248,1249
226,TalangEmpat,BengkuluTengah,Bengkulu,106.2112676,71,227,7541,3770,3771
227,AirBesi,BengkuluUtara,Bengkulu,80.45652174,92,228,7402,3701,3701
228,AirNapal,BengkuluUtara,Bengkulu,77.69911504,113,229,8780,4390,4390
229,ArgaMakmur,BengkuluUtara,Bengkulu,40.53617021,235,230,9526,4763,4763
230,BatikNau,BengkuluUtara,Bengkulu,26.6069869,229,231,6093,3046,3047
231,Enggano,BengkuluUtara,Bengkulu,13.65841584,202,232,2759,1379,1380
232,GiriMulya,BengkuluUtara,Bengkulu,49.3630137,146,233,7207,3603,3604
233,Hutan,BengkuluUtara,Bengkulu,0,657,234,0,0,0
234,Kerkap,BengkuluUtara,Bengkulu,34.03780069,291,235,9905,4952,4953
235,Lais,BengkuluUtara,Bengkulu,59.96995708,233,236,13973,6986,6987
236,NapalPutih,BengkuluUtara,Bengkulu,31.02915767,926,237,28733,14366,14367
237,PadangJaya,BengkuluUtara,Bengkulu,43.54054054,296,238,12888,6444,6444
238,KaurSelatan,Kaur,Bengkulu,34.74757282,103,239,3579,1789,1790
239,KaurTengah,Kaur,Bengkulu,38.88461538,26,240,1011,505,506
240,KaurUtara,Kaur,Bengkulu,17.93442623,61,241,1094,547,547
241,KelamTengah,Kaur,Bengkulu,14.61764706,34,242,497,248,249
242,Kinal,Kaur,Bengkulu,14.921875,192,243,2865,1432,1433
243,Luas,Kaur,Bengkulu,19.85074627,134,244,2660,1330,1330
244,LungkangKule,Kaur,Bengkulu,12.03571429,28,245,337,168,169
245,Maje,Kaur,Bengkulu,14.68463074,501,246,7357,3678,3679
246,MuaraSahung,Kaur,Bengkulu,26.63793103,290,247,7725,3862,3863
247,Nasal,Kaur,Bengkulu,6.456967213,488,248,3151,1575,1576
248,PadangGuciHilir,Kaur,Bengkulu,19.4496124,129,249,2509,1254,1255
249,PadangGuciHulu,Kaur,Bengkulu,5.550964187,363,250,2015,1007,1008
250,SemidangGumay,Kaur,Bengkulu,26.92682927,41,251,1104,552,552
251,TanjungKemuning,Kaur,Bengkulu,26.36708861,79,252,2083,1041,1042
252,Tetap,Kaur,Bengkulu,13.01149425,87,253,1132,566,566
253,BermaniIlir,Kepahiang,Bengkulu,57.75268817,93,254,5371,2685,2686
254,KabaWetan,Kepahiang,Bengkulu,15.42424242,99,255,1527,763,764
255,Kepahiang,Kepahiang,Bengkulu,131.9090909,66,256,8706,4353,4353
256,Merigi,Kepahiang,Bengkulu,1683.538462,13,257,21886,10943,10943
257,MuaraKemumu,Kepahiang,Bengkulu,40.26506024,166,258,6684,3342,3342
258,SeberangMusi,Kepahiang,Bengkulu,27.25892857,112,259,3053,1526,1527
259,TebatKarai,Kepahiang,Bengkulu,54.92063492,63,260,3460,1730,1730
260,UjanMas,Kepahiang,Bengkulu,89.53535354,99,261,8864,4432,4432
261,Amen,Lebong,Bengkulu,546.1176471,17,262,9284,4642,4642
262,BinginKuning,Lebong,Bengkulu,543.8857143,35,263,19036,9518,9518
263,LebongAtas,Lebong,Bengkulu,317.9473684,19,264,6041,3020,3021
264,LebongSakti,Lebong,Bengkulu,113.4528302,53,265,6013,3006,3007
265,LebongSelatan,Lebong,Bengkulu,226.4354839,186,266,42117,21058,21059
266,LebongTengah,Lebong,Bengkulu,213.8888889,99,267,21175,10587,10588
267,LebongUtara,Lebong,Bengkulu,908.9166667,24,268,21814,10907,10907
268,PadangBano,Lebong,Bengkulu,73.33333333,6,269,440,220,220
269,Pelabai,Lebong,Bengkulu,413.5714286,49,270,20265,10132,10133
270,PinangBelapis,Lebong,Bengkulu,45.88962109,607,271,27855,13927,13928
271,RimboPengadang,Lebong,Bengkulu,170.3605442,147,272,25043,12521,12522
272,Topos,Lebong,Bengkulu,38.30831099,373,273,14289,7144,7145
273,UramJaya,Lebong,Bengkulu,50.625,80,274,4050,2025,2025
274,BermaniUlu,RejangLebong,Bengkulu,207.1196581,117,275,24233,12116,12117
275,BermaniUluRaya,RejangLebong,Bengkulu,242.2043011,186,276,45050,22525,22525
276,BinduRiang,RejangLebong,Bengkulu,62.67692308,65,277,4074,2037,2037
277,Curup,RejangLebong,Bengkulu,5061.666667,3,278,15185,7592,7593
278,CurupSelatan,RejangLebong,Bengkulu,968.3235294,34,279,32923,16461,16462
279,CurupTengah,RejangLebong,Bengkulu,2609.25,12,280,31311,15655,15656
280,CurupTimur,RejangLebong,Bengkulu,1955.9,10,281,19559,9779,9780
281,CurupUtara,RejangLebong,Bengkulu,729.3953488,43,282,31364,15682,15682
282,KotaPadang,RejangLebong,Bengkulu,51.80232558,172,283,8910,4455,4455
283,PadangUlakTanding,RejangLebong,Bengkulu,66.39430894,246,284,16333,8166,8167
284,SelupuRejang,RejangLebong,Bengkulu,75.91712707,181,285,13741,6870,6871
285,SindangBelitiIlir,RejangLebong,Bengkulu,69.80571429,175,286,12216,6108,6108
286,SindangBelitiUlu,RejangLebong,Bengkulu,19.56557377,122,287,2387,1193,1194
287,SindangDataran,RejangLebong,Bengkulu,46.44897959,49,288,2276,1138,1138
288,SindangKelingi,RejangLebong,Bengkulu,64.04716981,106,289,6789,3394,3395
289,AirPeriukan,Seluma,Bengkulu,148.18125,160,290,23709,11854,11855
290,IlirTalo,Seluma,Bengkulu,107.5106383,94,291,10106,5053,5053
291,LubukSandi,Seluma,Bengkulu,22.32124352,193,292,4308,2154,2154
292,Seluma,Seluma,Bengkulu,78.83333333,24,293,1892,946,946
293,SelumaBarat,Seluma,Bengkulu,74.82,100,294,7482,3741,3741
294,SelumaSelatan,Seluma,Bengkulu,103.2903226,62,295,6404,3202,3202
295,SelumaTimur,Seluma,Bengkulu,38.23880597,67,296,2562,1281,1281
296,SelumaUtara,Seluma,Bengkulu,11.74768519,432,297,5075,2537,2538
297,SemidangAlas,Seluma,Bengkulu,14.64658635,498,298,7294,3647,3647
298,SemidangAlasMaras,Seluma,Bengkulu,84.30357143,112,299,9442,4721,4721
299,Sukaraja,Seluma,Bengkulu,86.32510288,243,300,20977,10488,10489
300,Talo,Seluma,Bengkulu,32.78504673,107,301,3508,1754,1754
301,TaloKecil,Seluma,Bengkulu,31.33333333,105,302,3290,1645,1645
302,UluTalo,Seluma,Bengkulu,6.642857143,280,303,1860,930,930
303,Cengkareng,JakartaBarat,JakartaRaya,12470.75,28,304,349181,174590,174591
304,Grogolpetamburan,JakartaBarat,JakartaRaya,20997.2,10,305,209972,104986,104986
305,Kalideres,JakartaBarat,JakartaRaya,9967.153846,26,306,259146,129573,129573
306,Kebonjeruk,JakartaBarat,JakartaRaya,20120.15789,19,307,382283,191141,191142
307,Kembangan,JakartaBarat,JakartaRaya,9587.16,25,308,239679,119839,119840
308,Palmerah,JakartaBarat,JakartaRaya,32989.33333,9,309,296904,148452,148452
309,Tamansari,JakartaBarat,JakartaRaya,47089.33333,6,310,282536,141268,141268
310,Tambora,JakartaBarat,JakartaRaya,37901.25,4,311,151605,75802,75803
311,CempakaPutih,JakartaPusat,JakartaRaya,16918.5,4,312,67674,33837,33837
312,Gambir,JakartaPusat,JakartaRaya,30733.66667,6,313,184402,92201,92201
313,JoharBaru,JakartaPusat,JakartaRaya,22452,3,314,67356,33678,33678
314,Kemayoran,JakartaPusat,JakartaRaya,14310.125,8,315,114481,57240,57241
315,Menteng,JakartaPusat,JakartaRaya,16860.875,8,316,134887,67443,67444
316,SawahBesar,JakartaPusat,JakartaRaya,21401.8,5,317,107009,53504,53505
317,Senen,JakartaPusat,JakartaRaya,16743.66667,3,318,50231,25115,25116
318,Tanahabang,JakartaPusat,JakartaRaya,11958.375,8,319,95667,47833,47834
319,Cilandak,JakartaSelatan,JakartaRaya,8267.105263,19,320,157075,78537,78538
320,Jagakarsa,JakartaSelatan,JakartaRaya,9227.44,25,321,230686,115343,115343
321,KabayoranLama,JakartaSelatan,JakartaRaya,24342.66667,3,322,73028,36514,36514
322,KebayoranBaru,JakartaSelatan,JakartaRaya,27432.23077,13,323,356619,178309,178310
323,KebayoranLama,JakartaSelatan,JakartaRaya,14679.53333,15,324,220193,110096,110097
324,MampangPrapatan,JakartaSelatan,JakartaRaya,12714.125,8,325,101713,50856,50857
325,Pancoran,JakartaSelatan,JakartaRaya,18261.44444,9,326,164353,82176,82177
326,PasarMinggu,JakartaSelatan,JakartaRaya,10716,21,327,225036,112518,112518
327,Pesanggrahan,JakartaSelatan,JakartaRaya,10819.45455,11,328,119014,59507,59507
328,SetiaBudi,JakartaSelatan,JakartaRaya,6910.5,4,329,27642,13821,13821
329,Setiabudi,JakartaSelatan,JakartaRaya,8511.142857,7,330,59578,29789,29789
330,Tebet,JakartaSelatan,JakartaRaya,19124.22222,9,331,172118,86059,86059
331,Cakung,JakartaTimur,JakartaRaya,15621.12195,41,332,640466,320233,320233
332,Cipayung,JakartaTimur,JakartaRaya,8254.444444,27,333,222870,111435,111435
333,Ciracas,JakartaTimur,JakartaRaya,12905.2,15,334,193578,96789,96789
334,DurenSawit,JakartaTimur,JakartaRaya,16428.95455,22,335,361437,180718,180719
335,Jatinegara,JakartaTimur,JakartaRaya,14863.9,10,336,148639,74319,74320
336,Kramatjati,JakartaTimur,JakartaRaya,19720.38462,13,337,256365,128182,128183
337,Makasar,JakartaTimur,JakartaRaya,7656.73913,23,338,176105,88052,88053
338,Matraman,JakartaTimur,JakartaRaya,31829.4,5,339,159147,79573,79574
339,Pasarrebo,JakartaTimur,JakartaRaya,14162.42857,14,340,198274,99137,99137
340,Pulogadung,JakartaTimur,JakartaRaya,19863,17,341,337671,168835,168836
341,Cilincing,JakartaUtara,JakartaRaya,7550.72093,43,342,324681,162340,162341
342,DanauSunterDll,JakartaUtara,JakartaRaya,,0,343,,0,0
343,KelapaGading,JakartaUtara,JakartaRaya,15568.17647,17,344,264659,132329,132330
344,Koja,JakartaUtara,JakartaRaya,19122.72727,11,345,210350,105175,105175
345,Pademangan,JakartaUtara,JakartaRaya,10022.85714,14,346,140320,70160,70160
346,Penjaringan,JakartaUtara,JakartaRaya,6759.825,40,347,270393,135196,135197
347,TanjungPriok,JakartaUtara,JakartaRaya,15476.77273,22,348,340489,170244,170245
348,KepulauanSeribuSelatan,KepulauanSeribu,JakartaRaya,918,2,349,1836,918,918
349,KepulauanSeribuUtara,KepulauanSeribu,JakartaRaya,0,6,350,0,0,0
350,Bajubang,BatangHari,Jambi,47.34084996,1153,351,54584,27292,27292
351,BatinXxiv,BatangHari,Jambi,39.48484848,924,352,36484,18242,18242
352,MaroSeboIlir,BatangHari,Jambi,42.73191489,235,353,10042,5021,5021
353,MaroSeboUlu,BatangHari,Jambi,46.14285714,791,354,36499,18249,18250
354,Mersam,BatangHari,Jambi,27.10455764,746,355,20220,10110,10110
355,MuaraBulian,BatangHari,Jambi,162,467,356,75654,37827,37827
356,MuaraTembesi,BatangHari,Jambi,50.82670455,352,357,17891,8945,8946
357,Pemayung,BatangHari,Jambi,53.36287425,835,358,44558,22279,22279
358,BathinIiBabeko,Bungo,Jambi,85.66666667,180,359,15420,7710,7710
359,BatinIii,Bungo,Jambi,146.297619,84,360,12289,6144,6145
360,BungoDani,Bungo,Jambi,679.1621622,37,361,25129,12564,12565
361,Muko-MukoBathin,Bungo,Jambi,24.75647668,193,362,4778,2389,2389
362,PasarMuaraBung,Bungo,Jambi,4443.4,10,363,44434,22217,22217
363,Pelepat,Bungo,Jambi,22.03049908,1082,364,23837,11918,11919
364,PelepatIlir,Bungo,Jambi,94.54176611,419,365,39613,19806,19807
365,RantauPandan,Bungo,Jambi,0.008333333,240,366,2,1,1
366,RimboTengah,Bungo,Jambi,220.212766,94,367,20700,10350,10350
367,TanahSepenggal,Bungo,Jambi,3.901785714,112,368,437,218,219
368,TanahSepenggalLintas,Bungo,Jambi,3.067567568,74,369,227,113,114
369,DanauTeluk,Jambi,Jambi,570.5882353,17,370,9700,4850,4850
370,JambiSelatan,Jambi,Jambi,3511.931034,29,371,101846,50923,50923
371,JambiTimur,Jambi,Jambi,4705.777778,18,372,84704,42352,42352
372,Jelutung,Jambi,Jambi,10573.16667,6,373,63439,31719,31720
373,KotaBaru,Jambi,Jambi,1968.074627,67,374,131861,65930,65931
374,PasarJambi,Jambi,Jambi,50059,1,375,50059,25029,25030
375,Pelayangan,Jambi,Jambi,905.375,8,376,7243,3621,3622
376,TelanaiPura,Jambi,Jambi,3391.458333,24,377,81395,40697,40698
377,Bangko,Merangin,Jambi,453.5357143,168,378,76194,38097,38097
378,BangkoBarat,Merangin,Jambi,38.19371728,191,379,7295,3647,3648
379,BatangMasumai,Merangin,Jambi,33.8490566,106,380,3588,1794,1794
380,LembahMasurai,Merangin,Jambi,3.602427921,659,381,2374,1187,1187
381,MargoTabir,Merangin,Jambi,175.6148148,135,382,23708,11854,11854
382,MuaraSiau,Merangin,Jambi,8.187004754,631,383,5166,2583,2583
383,NaloTantan,Merangin,Jambi,47.74778761,226,384,10791,5395,5396
384,Pamenang,Merangin,Jambi,102.5033784,296,385,30341,15170,15171
385,PamenangBarat,Merangin,Jambi,92.49723757,181,386,16742,8371,8371
386,PamenangSelatan,Merangin,Jambi,45.50625,160,387,7281,3640,3641
387,RenahPamenang,Merangin,Jambi,151.8686869,99,388,15035,7517,7518
388,RenahPembarap,Merangin,Jambi,11.98039216,306,389,3666,1833,1833
389,SungaiTenang,Merangin,Jambi,3.366003063,653,390,2198,1099,1099
390,Tabir,Merangin,Jambi,69.1179941,339,391,23431,11715,11716
391,TabirBarat,Merangin,Jambi,2.643442623,732,392,1935,967,968
392,TabirIlir,Merangin,Jambi,39.43624161,149,393,5876,2938,2938
393,TabirLintas,Merangin,Jambi,78.66371681,113,394,8889,4444,4445
394,TabirSelatan,Merangin,Jambi,80.04494382,178,395,14248,7124,7124
395,TabirTimur,Merangin,Jambi,59.08450704,71,396,4195,2097,2098
396,TabirUlu,Merangin,Jambi,15.04945055,182,397,2739,1369,1370
397,TiangPumpung,Merangin,Jambi,20.67615658,281,398,5810,2905,2905
398,JambiLuarKota,MuaroJambi,Jambi,183.4190476,315,399,57777,28888,28889
399,Kumpeh,MuaroJambi,Jambi,3.433675967,2043,400,7015,3507,3508
400,KumpehUlu,MuaroJambi,Jambi,52.30512821,390,401,20399,10199,10200
401,MaroSebo,MuaroJambi,Jambi,43.498998,499,402,21706,10853,10853
402,Mestong,MuaroJambi,Jambi,106.5173824,489,403,52087,26043,26044
403,Sekernan,MuaroJambi,Jambi,46.61809816,652,404,30395,15197,15198
404,SungaiBahar,MuaroJambi,Jambi,90.671875,512,405,46424,23212,23212
405,SungaiGelam,MuaroJambi,Jambi,54.58551618,649,406,35426,17713,17713
406,AirHitam,Sarolangun,Jambi,51.73970588,680,407,35183,17591,17592
407,Batangasai,Sarolangun,Jambi,23.89562624,1006,408,24039,12019,12020
408,BatinViii,Sarolangun,Jambi,58.20467836,342,409,19906,9953,9953
409,CerminNanGedan,Sarolangun,Jambi,22.07990315,413,410,9119,4559,4560
410,Limun,Sarolangun,Jambi,11.57571623,733,411,8485,4242,4243
411,Mandiangin,Sarolangun,Jambi,38.29982363,1134,412,43432,21716,21716
412,Pauh,Sarolangun,Jambi,66.27525253,792,413,52490,26245,26245
413,Pelawan,Sarolangun,Jambi,52.16147309,353,414,18413,9206,9207
414,Sarolangun,Sarolangun,Jambi,155.3297491,279,415,43337,21668,21669
415,Singkut,Sarolangun,Jambi,63.13612565,191,416,12059,6029,6030
416,BatangAsam,TanjungJabungB,Jambi,55.83206107,1048,417,58512,29256,29256
417,Betara,TanjungJabungB,Jambi,26.14102564,546,418,14273,7136,7137
418,BramItam,TanjungJabungB,Jambi,27.97738693,398,419,11135,5567,5568
419,KualaBetara,TanjungJabungB,Jambi,82.61271676,173,420,14292,7146,7146
420,Merlung,TanjungJabungB,Jambi,105.625,280,421,29575,14787,14788
421,MuaraPapalik,TanjungJabungB,Jambi,115.1148459,357,422,41096,20548,20548
422,Pengabuan,TanjungJabungB,Jambi,31.22343324,367,423,11459,5729,5730
423,RenahMendaluh,TanjungJabungB,Jambi,46.69957983,476,424,22229,11114,11115
424,SeberangKota,TanjungJabungB,Jambi,80.15789474,114,425,9138,4569,4569
425,Senyerang,TanjungJabungB,Jambi,57.62937063,429,426,24723,12361,12362
426,TebingTinggi,TanjungJabungB,Jambi,60.65449438,356,427,21593,10796,10797
427,TungkalIlir,TanjungJabungB,Jambi,528.505618,89,428,47037,23518,23519
428,TungkalUlu,TanjungJabungB,Jambi,141.1975309,324,429,45748,22874,22874
429,Berbak,TanjungJabungT,Jambi,11.00732601,273,430,3005,1502,1503
430,Dendang,TanjungJabungT,Jambi,46.13988095,336,431,15503,7751,7752
431,Geragai,TanjungJabungT,Jambi,4.791497976,494,432,2367,1183,1184
432,Hutan,TanjungJabungT,Jambi,1.106285714,875,433,968,484,484
433,KualaJambi,TanjungJabungT,Jambi,45.89655172,116,434,5324,2662,2662
434,Mendahara,TanjungJabungT,Jambi,66.43168317,505,435,33548,16774,16774
435,MendaharaUlu,TanjungJabungT,Jambi,16.70598291,585,436,9773,4886,4887
436,NipahPanjang,TanjungJabungT,Jambi,67.2244898,294,437,19764,9882,9882
437,RantauRasau,TanjungJabungT,Jambi,13.88888889,198,438,2750,1375,1375
438,SabakBarat,TanjungJabungT,Jambi,21.16245487,277,439,5862,2931,2931
439,SabakTimur,TanjungJabungT,Jambi,75.61576355,406,440,30700,15350,15350
440,Sadu,TanjungJabungT,Jambi,28.15923567,628,441,17684,8842,8842
441,MuaraTabir,Tebo,Jambi,26.83429395,694,442,18623,9311,9312
442,RimboBujang,Tebo,Jambi,65.38011696,342,443,22360,11180,11180
443,RimboIlir,Tebo,Jambi,57.9351145,262,444,15179,7589,7590
444,RimboUlu,Tebo,Jambi,34.05785124,363,445,12363,6181,6182
445,SeraiSerumpun,Tebo,Jambi,13.00714286,420,446,5463,2731,2732
446,Sumay,Tebo,Jambi,12.91414141,1188,447,15342,7671,7671
447,TeboIlir,Tebo,Jambi,63.25890736,421,448,26632,13316,13316
448,TeboTengah,Tebo,Jambi,66.27357238,753,449,49904,24952,24952
449,TeboUlu,Tebo,Jambi,83.68539326,178,450,14896,7448,7448
450,TengahIlir,Tebo,Jambi,27.10643016,451,451,12225,6112,6113
451,ViiKoto,Tebo,Jambi,13.11082138,767,452,10056,5028,5028
452,ViiKotoIlir,Tebo,Jambi,10.97007481,401,453,4399,2199,2200
453,Arjasari,Bandung,JawaBarat,1298.921875,64,454,83131,41565,41566
454,Baleendah,Bandung,JawaBarat,4251,41,455,174291,87145,87146
455,Banjaran,Bandung,JawaBarat,2372.128205,39,456,92513,46256,46257
456,Bojongsoang,Bandung,JawaBarat,3353,29,457,97237,48618,48619
457,Cangkuang,Bandung,JawaBarat,2464.391304,23,458,56681,28340,28341
458,Cicalengka,Bandung,JawaBarat,3108.465116,43,459,133664,66832,66832
459,Cikancung,Bandung,JawaBarat,2590.868421,38,460,98453,49226,49227
460,Cilengkrang,Bandung,JawaBarat,1135.272727,44,461,49952,24976,24976
461,Cileunyi,Bandung,JawaBarat,5567.290323,31,462,172586,86293,86293
462,Cimaung,Bandung,JawaBarat,647.3934426,61,463,39491,19745,19746
463,Cimenyan,Bandung,JawaBarat,2218.489362,47,464,104269,52134,52135
464,Ciparay,Bandung,JawaBarat,2399.363636,55,465,131965,65982,65983
465,Ciwidey,Bandung,JawaBarat,1547.456522,46,466,71183,35591,35592
466,Dayeuhkolot,Bandung,JawaBarat,7118.636364,11,467,78305,39152,39153
467,Ibun,Bandung,JawaBarat,631.4166667,60,468,37885,18942,18943
468,Katapang,Bandung,JawaBarat,4528.529412,17,469,76985,38492,38493
469,Kertasari,Bandung,JawaBarat,504.4350649,154,470,77683,38841,38842
470,Kutawaringin,Bandung,JawaBarat,2091.333333,45,471,94110,47055,47055
471,Majalaya,Bandung,JawaBarat,5769.863636,22,472,126937,63468,63469
472,Margaasih,Bandung,JawaBarat,5736.095238,21,473,120458,60229,60229
473,Margahayu,Bandung,JawaBarat,5105.090909,11,474,56156,28078,28078
474,Nagreg,Bandung,JawaBarat,1774.658537,41,475,72761,36380,36381
475,Pacet,Bandung,JawaBarat,737.2061856,97,476,71509,35754,35755
476,Pameungpeuk,Bandung,JawaBarat,2495.333333,15,477,37430,18715,18715
477,Pangalengan,Bandung,JawaBarat,597.1131222,221,478,131962,65981,65981
478,Paseh,Bandung,JawaBarat,2789.705882,51,479,142275,71137,71138
479,Pasirjambu,Bandung,JawaBarat,346.8275862,203,480,70406,35203,35203
480,Rancabali,Bandung,JawaBarat,270.6184211,152,481,41134,20567,20567
481,Rancaekek,Bandung,JawaBarat,3449.521739,46,482,158678,79339,79339
482,SolokanJeruk,Bandung,JawaBarat,3040.333333,24,483,72968,36484,36484
483,Soreang,Bandung,JawaBarat,4477.857143,28,484,125380,62690,62690
484,Batujajar,BandungBarat,JawaBarat,1893.647887,71,485,134449,67224,67225
485,Cihampelas,BandungBarat,JawaBarat,1905.414634,41,486,78122,39061,39061
486,CikalongWetan,BandungBarat,JawaBarat,1324.236842,114,487,150963,75481,75482
487,Cililin,BandungBarat,JawaBarat,770.9384615,65,488,50111,25055,25056
488,Cipatat,BandungBarat,JawaBarat,1221.856,125,489,152732,76366,76366
489,Cipeundeuy,BandungBarat,JawaBarat,668.3255814,86,490,57476,28738,28738
490,Cipongkor,BandungBarat,JawaBarat,840.8125,80,491,67265,33632,33633
491,Cisarua,BandungBarat,JawaBarat,2196.679245,53,492,116424,58212,58212
492,Gununghalu,BandungBarat,JawaBarat,306.2095808,167,493,51137,25568,25569
493,Lembang,BandungBarat,JawaBarat,3555.010309,97,494,344836,172418,172418
494,Ngamprah,BandungBarat,JawaBarat,4579.242424,33,495,151115,75557,75558
495,Padalarang,BandungBarat,JawaBarat,3841.745455,55,496,211296,105648,105648
496,Parongpong,BandungBarat,JawaBarat,2928.581395,43,497,125929,62964,62965
497,Rongga,BandungBarat,JawaBarat,524.0847458,118,498,61842,30921,30921
498,Sindangkerta,BandungBarat,JawaBarat,523.7037037,108,499,56560,28280,28280
499,Waduk,BandungBarat,JawaBarat,1129.947368,38,500,42938,21469,21469
500,Babelan,Bekasi,JawaBarat,2979.28169,71,501,211529,105764,105765
501,Bojongmangu,Bekasi,JawaBarat,841.7169811,53,502,44611,22305,22306
502,Cabangbungin,Bekasi,JawaBarat,900.8627451,51,503,45944,22972,22972
503,Cibarusah,Bekasi,JawaBarat,1814.414634,41,504,74391,37195,37196
504,Cibitung,Bekasi,JawaBarat,3090.590909,44,505,135986,67993,67993
505,CikarangBarat,Bekasi,JawaBarat,2476.773585,53,506,131269,65634,65635
506,CikarangPusat,Bekasi,JawaBarat,1220.636364,55,507,67135,33567,33568
507,CikarangSelatan,Bekasi,JawaBarat,2603.980769,52,508,135407,67703,67704
508,CikarangTimur,Bekasi,JawaBarat,1546.823529,51,509,78888,39444,39444
509,CikarangUtara,Bekasi,JawaBarat,3708.833333,42,510,155771,77885,77886
510,Karangbahagia,Bekasi,JawaBarat,1441.222222,45,511,64855,32427,32428
511,Kedungwaringin,Bekasi,JawaBarat,1186.647059,34,512,40346,20173,20173
512,MuaraGembong,Bekasi,JawaBarat,635.4039735,151,513,95946,47973,47973
513,Pebayuran,Bekasi,JawaBarat,916.3917526,97,514,88890,44445,44445
514,SerangBaru,Bekasi,JawaBarat,2182.677419,62,515,135326,67663,67663
515,Setu,Bekasi,JawaBarat,1909.359375,64,516,122199,61099,61100
516,Sukakarya,Bekasi,JawaBarat,1169.978723,47,517,54989,27494,27495
517,Sukatani,Bekasi,JawaBarat,1631.7,40,518,65268,32634,32634
518,Sukawangi,Bekasi,JawaBarat,904.7794118,68,519,61525,30762,30763
519,Tambelang,Bekasi,JawaBarat,898.8787879,33,520,29663,14831,14832
520,TambunSelatan,Bekasi,JawaBarat,5334.309524,42,521,224041,112020,112021
521,TambunUtara,Bekasi,JawaBarat,4005.457143,35,522,140191,70095,70096
522,Tarumajaya,Bekasi,JawaBarat,2099.403846,52,523,109169,54584,54585
523,BabakanMadang,Bogor,JawaBarat,931.9325843,89,524,82942,41471,41471
524,BojongGede,Bogor,JawaBarat,3915.034483,29,525,113536,56768,56768
525,Caringin,Bogor,JawaBarat,262.0649351,77,526,20179,10089,10090
526,Cariu,Bogor,JawaBarat,949.3103448,87,527,82590,41295,41295
527,Ciampea,Bogor,JawaBarat,2265.2,30,528,67956,33978,33978
528,Ciawi,Bogor,JawaBarat,827.5686275,51,529,42206,21103,21103
529,Cibinong,Bogor,JawaBarat,5488.042553,47,530,257938,128969,128969
530,Cibungbulang,Bogor,JawaBarat,1529,40,531,61160,30580,30580
531,Cigombong,Bogor,JawaBarat,447.1702128,47,532,21017,10508,10509
532,Cigudeg,Bogor,JawaBarat,147.8666667,180,533,26616,13308,13308
533,Cijeruk,Bogor,JawaBarat,628.3333333,48,534,30160,15080,15080
534,Cileungsi,Bogor,JawaBarat,4215.957746,71,535,299333,149666,149667
535,Ciomas,Bogor,JawaBarat,3743.388889,18,536,67381,33690,33691
536,Cisarua,Bogor,JawaBarat,965.617284,81,537,78215,39107,39108
537,Ciseeng,Bogor,JawaBarat,2787.157895,38,538,105912,52956,52956
538,Citeureup,Bogor,JawaBarat,2293.202899,69,539,158231,79115,79116
539,Dramaga,Bogor,JawaBarat,1595.814815,27,540,43087,21543,21544
540,GunungPutri,Bogor,JawaBarat,5335.603175,63,541,336143,168071,168072
541,GunungSindur,Bogor,JawaBarat,2186.196078,51,542,111496,55748,55748
542,Jasinga,Bogor,JawaBarat,460.0758621,145,543,66711,33355,33356
543,Jonggol,Bogor,JawaBarat,1768.231884,138,544,244016,122008,122008
544,KelapaNunggal,Bogor,JawaBarat,1218.659794,97,545,118210,59105,59105
545,Kemang,Bogor,JawaBarat,3440.515152,33,546,113537,56768,56769
546,Leuwiliang,Bogor,JawaBarat,282.1630435,92,547,25959,12979,12980
547,Leuwisadeng,Bogor,JawaBarat,808.6571429,35,548,28303,14151,14152
548,Megamendung,Bogor,JawaBarat,740.0333333,60,549,44402,22201,22201
549,Nanggung,Bogor,JawaBarat,142.1768293,164,550,23317,11658,11659
550,Pamijahan,Bogor,JawaBarat,105.1428571,126,551,13248,6624,6624
551,Parung,Bogor,JawaBarat,3552.035714,28,552,99457,49728,49729
552,ParungPanjang,Bogor,JawaBarat,3098.15942,69,553,213773,106886,106887
553,RancaBungur,Bogor,JawaBarat,2372.666667,24,554,56944,28472,28472
554,Rumpin,Bogor,JawaBarat,863.3732394,142,555,122599,61299,61300
555,Sukajaya,Bogor,JawaBarat,49.29012346,162,556,7985,3992,3993
556,Sukamakmur,Bogor,JawaBarat,271.0702703,185,557,50148,25074,25074
557,Sukaraja,Bogor,JawaBarat,3557.782609,46,558,163658,81829,81829
558,TajurHalang,Bogor,JawaBarat,2120.2,30,559,63606,31803,31803
559,Tamansari,Bogor,JawaBarat,863.425,40,560,34537,17268,17269
560,Tanjungsari,Bogor,JawaBarat,361.1733333,150,561,54176,27088,27088
561,Tenjo,Bogor,JawaBarat,1228.094118,85,562,104388,52194,52194
562,Tenjolaya,Bogor,JawaBarat,261.6756757,37,563,9682,4841,4841
563,Cihaurbeuti,Ciamis,JawaBarat,229.8358209,67,564,15399,7699,7700
564,Panumbangan,Ciamis,JawaBarat,64.48214286,56,565,3611,1805,1806
565,Agrabinta,Cianjur,JawaBarat,928.763285,207,566,192254,96127,96127
566,Bojongpicung,Cianjur,JawaBarat,240.8064516,93,567,22395,11197,11198
567,Campaka,Cianjur,JawaBarat,392.3356643,143,568,56104,28052,28052
568,CampakaMulya,Cianjur,JawaBarat,90.06756757,74,569,6665,3332,3333
569,Cianjur,Cianjur,JawaBarat,6610.111111,27,570,178473,89236,89237
570,Cibeber,Cianjur,JawaBarat,599.5396825,126,571,75542,37771,37771
571,Cibinong,Cianjur,JawaBarat,669.9876543,243,572,162807,81403,81404
572,Cidaun,Cianjur,JawaBarat,741.4496644,298,573,220952,110476,110476
573,Cijati,Cianjur,JawaBarat,427.2244898,49,574,20934,10467,10467
574,Cikadu,Cianjur,JawaBarat,211.625,192,575,40632,20316,20316
575,Cikalongkulon,Cianjur,JawaBarat,275.2189781,137,576,37705,18852,18853
576,Cilaku,Cianjur,JawaBarat,662.1428571,49,577,32445,16222,16223
577,Cipanas,Cianjur,JawaBarat,1010.076923,65,578,65655,32827,32828
578,Ciranjang,Cianjur,JawaBarat,2424.735294,34,579,82441,41220,41221
579,Cugenang,Cianjur,JawaBarat,462.2948718,78,580,36059,18029,18030
580,Gekbrong,Cianjur,JawaBarat,699.2244898,49,581,34262,17131,17131
581,Haurwangi,Cianjur,JawaBarat,1032.488889,45,582,46462,23231,23231
582,Kadupandak,Cianjur,JawaBarat,217.9363636,110,583,23973,11986,11987
583,Karangtengah,Cianjur,JawaBarat,2596.891304,46,584,119457,59728,59729
584,Leles,Cianjur,JawaBarat,986.7117117,111,585,109525,54762,54763
585,Mande,Cianjur,JawaBarat,479.5172414,87,586,41718,20859,20859
586,Naringgul,Cianjur,JawaBarat,144.0596491,285,587,41057,20528,20529
587,Pacet,Cianjur,JawaBarat,1620.342105,38,588,61573,30786,30787
588,Pagelaran,Cianjur,JawaBarat,109.6195122,205,589,22472,11236,11236
589,Pasirkuda,Cianjur,JawaBarat,109.009434,106,590,11555,5777,5778
590,Sindangbarang,Cianjur,JawaBarat,1618.035928,167,591,270212,135106,135106
591,Sukaluyu,Cianjur,JawaBarat,1266.893617,47,592,59544,29772,29772
592,Sukanagara,Cianjur,JawaBarat,536.2356322,174,593,93305,46652,46653
593,Sukaresmi,Cianjur,JawaBarat,382.6767677,99,594,37885,18942,18943
594,Takokak,Cianjur,JawaBarat,163.8551724,145,595,23759,11879,11880
595,Tanggeung,Cianjur,JawaBarat,498.9846154,65,596,32434,16217,16217
596,Warungkondang,Cianjur,JawaBarat,529.1666667,48,597,25400,12700,12700
597,CimahiSelatan,Cimahi,JawaBarat,6543.5625,16,598,104697,52348,52349
598,CimahiTengah,Cimahi,JawaBarat,10165.5,12,599,121986,60993,60993
599,CimahiUtara,Cimahi,JawaBarat,5316.714286,14,600,74434,37217,37217
600,Beji,Depok,JawaBarat,8369.071429,14,601,117167,58583,58584
601,Bojongsari,Depok,JawaBarat,5827.3,20,602,116546,58273,58273
602,Cilodong,Depok,JawaBarat,6687.6875,16,603,107003,53501,53502
603,Cimanggis,Depok,JawaBarat,9186.478261,23,604,211289,105644,105645
604,Cinere,Depok,JawaBarat,6346.818182,11,605,69815,34907,34908
605,Cipayung,Depok,JawaBarat,8728.9,10,606,87289,43644,43645
606,Limo,Depok,JawaBarat,6172.454545,11,607,67897,33948,33949
607,PancoranMas,Depok,JawaBarat,10183.16667,18,608,183297,91648,91649
608,Sawangan,Depok,JawaBarat,5133.37931,29,609,148868,74434,74434
609,SukmaJaya,Depok,JawaBarat,9107.055556,18,610,163927,81963,81964
610,Tapos,Depok,JawaBarat,4637.162162,37,611,171575,85787,85788
611,Banjarwangi,Garut,JawaBarat,223.4516129,124,612,27708,13854,13854
612,Banyuresmi,Garut,JawaBarat,1076.102041,49,613,52729,26364,26365
613,Bayongbong,Garut,JawaBarat,1168.434783,46,614,53748,26874,26874
614,BluburLimbangan,Garut,JawaBarat,1119.090909,88,615,98480,49240,49240
615,Bungbulang,Garut,JawaBarat,941.0650888,169,616,159040,79520,79520
616,Caringin,Garut,JawaBarat,814.5641026,117,617,95304,47652,47652
617,Cibalong,Garut,JawaBarat,666.8675799,219,618,146044,73022,73022
618,Cibatu,Garut,JawaBarat,1099.128205,39,619,42866,21433,21433
619,Cibiuk,Garut,JawaBarat,1661.173913,23,620,38207,19103,19104
620,Cigedug,Garut,JawaBarat,517.90625,32,621,16573,8286,8287
621,Cihurip,Garut,JawaBarat,206.6521739,46,622,9506,4753,4753
622,Cikajang,Garut,JawaBarat,1255.669725,109,623,136868,68434,68434
623,Cikelet,Garut,JawaBarat,1038.102273,176,624,182706,91353,91353
624,Cilawu,Garut,JawaBarat,1250.142857,84,625,105012,52506,52506
625,Cisewu,Garut,JawaBarat,116.0181818,165,626,19143,9571,9572
626,Cisompet,Garut,JawaBarat,380.8678161,174,627,66271,33135,33136
627,Cisurupan,Garut,JawaBarat,928.7391304,92,628,85444,42722,42722
628,GarutKota,Garut,JawaBarat,4424.548387,31,629,137161,68580,68581
629,Kadungora,Garut,JawaBarat,897.475,40,630,35899,17949,17950
630,Karangpawitan,Garut,JawaBarat,848.5,56,631,47516,23758,23758
631,Karangtengah,Garut,JawaBarat,276.4444444,27,632,7464,3732,3732
632,Kersamanah,Garut,JawaBarat,2069.28,25,633,51732,25866,25866
633,Leles,Garut,JawaBarat,564.3108108,74,634,41759,20879,20880
634,Leuwigoong,Garut,JawaBarat,900.5454545,22,635,19812,9906,9906
635,Malangbong,Garut,JawaBarat,873.1121495,107,636,93423,46711,46712
636,Mekarmukti,Garut,JawaBarat,2326,45,637,104670,52335,52335
637,Pakenjeng,Garut,JawaBarat,278.7589744,195,638,54358,27179,27179
638,Pameungpeuk,Garut,JawaBarat,1840.132075,53,639,97527,48763,48764
639,Pamulihan,Garut,JawaBarat,49.32758621,116,640,5722,2861,2861
640,Pangatikan,Garut,JawaBarat,468.047619,21,641,9829,4914,4915
641,Pasirwangi,Garut,JawaBarat,313.0754717,53,642,16593,8296,8297
642,Peundeuy,Garut,JawaBarat,467.1071429,56,643,26158,13079,13079
643,Samarang,Garut,JawaBarat,635.8518519,54,644,34336,17168,17168
644,Selaawi,Garut,JawaBarat,790.3947368,38,645,30035,15017,15018
645,Singajaya,Garut,JawaBarat,241.516129,62,646,14974,7487,7487
646,Sucinaraja,Garut,JawaBarat,406.6451613,31,647,12606,6303,6303
647,Sukaresmi,Garut,JawaBarat,363.7142857,35,648,12730,6365,6365
648,Sukawening,Garut,JawaBarat,551.8,40,649,22072,11036,11036
649,Talegong,Garut,JawaBarat,134.7837838,111,650,14961,7480,7481
650,TarogongKaler,Garut,JawaBarat,591.5686275,51,651,30170,15085,15085
651,TarogongKidul,Garut,JawaBarat,6842.636364,22,652,150538,75269,75269
652,Wanaraja,Garut,JawaBarat,893.68,25,653,22342,11171,11171
653,Anjatan,Indramayu,JawaBarat,454.4204545,88,654,39989,19994,19995
654,Bongas,Indramayu,JawaBarat,1062.040816,49,655,52040,26020,26020
655,Cantigi,Indramayu,JawaBarat,0,58,656,0,0,0
656,Cikedung,Indramayu,JawaBarat,505.5130435,115,657,58134,29067,29067
657,Gabuswetan,Indramayu,JawaBarat,598.625,80,658,47890,23945,23945
658,Gantar,Indramayu,JawaBarat,218.0924855,173,659,37730,18865,18865
659,Haurgeulis,Indramayu,JawaBarat,575.09375,64,660,36806,18403,18403
660,Kandanghaur,Indramayu,JawaBarat,1224.965116,86,661,105347,52673,52674
661,Kroya,Indramayu,JawaBarat,208.4892086,139,662,28980,14490,14490
662,Lelea,Indramayu,JawaBarat,7,61,663,427,213,214
663,Losarang,Indramayu,JawaBarat,495.5285714,140,664,69374,34687,34687
664,Patrol,Indramayu,JawaBarat,884.3255814,43,665,38026,19013,19013
665,Sukra,Indramayu,JawaBarat,423.0487805,41,666,17345,8672,8673
666,Terisi,Indramayu,JawaBarat,450.5898876,178,667,80205,40102,40103
667,Banyusari,Karawang,JawaBarat,931.1578947,57,668,53076,26538,26538
668,Batujaya,Karawang,JawaBarat,1543.460526,76,669,117303,58651,58652
669,Ciampel,Karawang,JawaBarat,422.2966102,118,670,49831,24915,24916
670,Cibuaya,Karawang,JawaBarat,429.7666667,120,671,51572,25786,25786
671,Cikampek,Karawang,JawaBarat,3010.923077,39,672,117426,58713,58713
672,CilamayaKulon,Karawang,JawaBarat,825.3857143,70,673,57777,28888,28889
673,CilamayaWetan,Karawang,JawaBarat,1174.394737,76,674,89254,44627,44627
674,Cilebar,Karawang,JawaBarat,654.8285714,70,675,45838,22919,22919
675,Jatisari,Karawang,JawaBarat,1143.962963,54,676,61774,30887,30887
676,Jayakerta,Karawang,JawaBarat,1571.023256,43,677,67554,33777,33777
677,KarawangBarat,Karawang,JawaBarat,5270.166667,42,678,221347,110673,110674
678,KarawangTimur,Karawang,JawaBarat,3353.033333,30,679,100591,50295,50296
679,Klari,Karawang,JawaBarat,2163.066667,75,680,162230,81115,81115
680,Kotabaru,Karawang,JawaBarat,2243.166667,36,681,80754,40377,40377
681,Kutawaluya,Karawang,JawaBarat,1191.944444,54,682,64365,32182,32183
682,Lemahabang,Karawang,JawaBarat,953.8461538,52,683,49600,24800,24800
683,Majalaya,Karawang,JawaBarat,1434.310345,29,684,41595,20797,20798
684,Pakisjaya,Karawang,JawaBarat,833.2461538,65,685,54161,27080,27081
685,Pangkalan,Karawang,JawaBarat,529.7216495,97,686,51383,25691,25692
686,Pedes,Karawang,JawaBarat,1327.434783,69,687,91593,45796,45797
687,Purwasari,Karawang,JawaBarat,1471.114286,35,688,51489,25744,25745
688,Rawamerta,Karawang,JawaBarat,973.6792453,53,689,51605,25802,25803
689,Rengasdengklok,Karawang,JawaBarat,2753.119048,42,690,115631,57815,57816
690,Talagasari,Karawang,JawaBarat,1444.160714,56,691,80873,40436,40437
691,Tegalwaru,Karawang,JawaBarat,227.3272727,110,692,25006,12503,12503
692,TelukjambeBarat,Karawang,JawaBarat,1011.276316,76,693,76857,38428,38429
693,TelukjambeTimur,Karawang,JawaBarat,1794.414634,41,694,73571,36785,36786
694,Tempuran,Karawang,JawaBarat,862.7446809,94,695,81098,40549,40549
695,Tirtajaya,Karawang,JawaBarat,597.1636364,110,696,65688,32844,32844
696,Tirtamulya,Karawang,JawaBarat,782.3191489,47,697,36769,18384,18385
697,Andir,KotaBandung,JawaBarat,20416.5,2,698,40833,20416,20417
698,Antapani,KotaBandung,JawaBarat,5369.5,4,699,21478,10739,10739
699,Arcamanik,KotaBandung,JawaBarat,3996.166667,6,700,23977,11988,11989
700,Astanaanyar,KotaBandung,JawaBarat,26754.66667,3,701,80264,40132,40132
701,BabakanCiparay,KotaBandung,JawaBarat,15225,7,702,106575,53287,53288
702,BandungKidul,KotaBandung,JawaBarat,9191.25,4,703,36765,18382,18383
703,BandungKulon,KotaBandung,JawaBarat,13263.16667,6,704,79579,39789,39790
704,BandungWetan,KotaBandung,JawaBarat,45003.25,4,705,180013,90006,90007
705,Batununggal,KotaBandung,JawaBarat,25419,5,706,127095,63547,63548
706,BojongloaKaler,KotaBandung,JawaBarat,41927,4,707,167708,83854,83854
707,BojongloaKidul,KotaBandung,JawaBarat,14219,4,708,56876,28438,28438
708,Buahbatu,KotaBandung,JawaBarat,9924.428571,7,709,69471,34735,34736
709,CibeunyingKaler,KotaBandung,JawaBarat,8687.2,5,710,43436,21718,21718
710,CibeunyingKidul,KotaBandung,JawaBarat,8955.25,4,711,35821,17910,17911
711,Cibiru,KotaBandung,JawaBarat,10273.33333,6,712,61640,30820,30820
712,Cicendo,KotaBandung,JawaBarat,23679.77778,9,713,213118,106559,106559
713,Cidadap,KotaBandung,JawaBarat,6427.857143,7,714,44995,22497,22498
714,Cinambo,KotaBandung,JawaBarat,4415.333333,3,715,13246,6623,6623
715,Coblong,KotaBandung,JawaBarat,23657.875,8,716,189263,94631,94632
716,Gedebage,KotaBandung,JawaBarat,3053.333333,9,717,27480,13740,13740
717,Kiaracondong,KotaBandung,JawaBarat,11744.83333,6,718,70469,35234,35235
718,Lengkong,KotaBandung,JawaBarat,17854.57143,7,719,124982,62491,62491
719,Mandalajati,KotaBandung,JawaBarat,3391.4,5,720,16957,8478,8479
720,Panyileukan,KotaBandung,JawaBarat,7079.666667,6,721,42478,21239,21239
721,Rancasari,KotaBandung,JawaBarat,9453.444444,9,722,85081,42540,42541
722,Regol,KotaBandung,JawaBarat,32628.25,4,723,130513,65256,65257
723,Sukajadi,KotaBandung,JawaBarat,23254.25,4,724,93017,46508,46509
724,Sukasari,KotaBandung,JawaBarat,9966.166667,6,725,59797,29898,29899
725,SumurBandung,KotaBandung,JawaBarat,46908.75,4,726,187635,93817,93818
726,UjungBerung,KotaBandung,JawaBarat,9239.4,5,727,46197,23098,23099
727,Bantargebang,KotaBekasi,JawaBarat,3367.210526,19,728,63977,31988,31989
728,BekasiBarat,KotaBekasi,JawaBarat,19910.6,15,729,298659,149329,149330
729,BekasiSelatan,KotaBekasi,JawaBarat,8882.75,16,730,142124,71062,71062
730,BekasiTimur,KotaBekasi,JawaBarat,13477.4,15,731,202161,101080,101081
731,BekasiUtara,KotaBekasi,JawaBarat,12522.5,22,732,275495,137747,137748
732,Jatiasih,KotaBekasi,JawaBarat,5314.043478,23,733,122223,61111,61112
733,Jatisampurna,KotaBekasi,JawaBarat,4736.388889,18,734,85255,42627,42628
734,MedanSatria,KotaBekasi,JawaBarat,12601.92857,14,735,176427,88213,88214
735,Mustikajaya,KotaBekasi,JawaBarat,6222.24,25,736,155556,77778,77778
736,Pondokgede,KotaBekasi,JawaBarat,9537.0625,16,737,152593,76296,76297
737,Pondokmelati,KotaBekasi,JawaBarat,6014.357143,14,738,84201,42100,42101
738,Rawalumbu,KotaBekasi,JawaBarat,7347.117647,17,739,124901,62450,62451
739,BogorBarat,KotaBogor,JawaBarat,8932.208333,24,740,214373,107186,107187
740,BogorSelatan,KotaBogor,JawaBarat,4060.967742,31,741,125890,62945,62945
741,BogorTengah,KotaBogor,JawaBarat,26500.125,8,742,212001,106000,106001
742,BogorTimur,KotaBogor,JawaBarat,9424.333333,9,743,84819,42409,42410
743,BogorUtara,KotaBogor,JawaBarat,7203.333333,18,744,129660,64830,64830
744,TanahSereal,KotaBogor,JawaBarat,5737.652174,23,745,131966,65983,65983
745,Baros,KotaSukabumi,JawaBarat,5496.666667,6,746,32980,16490,16490
746,Cibeureum,KotaSukabumi,JawaBarat,3567.454545,11,747,39242,19621,19621
747,Cikole,KotaSukabumi,JawaBarat,11376.57143,7,748,79636,39818,39818
748,Citamiang,KotaSukabumi,JawaBarat,11549.25,4,749,46197,23098,23099
749,GunungPuyuh,KotaSukabumi,JawaBarat,6333.8,5,750,31669,15834,15835
750,Lembursitu,KotaSukabumi,JawaBarat,2850.818182,11,751,31359,15679,15680
751,Warudoyong,KotaSukabumi,JawaBarat,10448,10,752,104480,52240,52240
752,Bungursari,KotaTasikmalaya,JawaBarat,2207.666667,18,753,39738,19869,19869
753,Cihideung,KotaTasikmalaya,JawaBarat,0,7,754,0,0,0
754,Cipedes,KotaTasikmalaya,JawaBarat,486.8888889,9,755,4382,2191,2191
755,Indihiang,KotaTasikmalaya,JawaBarat,4850.666667,12,756,58208,29104,29104
756,Kawalu,KotaTasikmalaya,JawaBarat,351.1395349,43,757,15099,7549,7550
757,Mangkubumi,KotaTasikmalaya,JawaBarat,1764.954545,22,758,38829,19414,19415
758,Bantarujeg,Majalengka,JawaBarat,0,69,759,0,0,0
759,Dawuan,Majalengka,JawaBarat,1380.733333,30,760,41422,20711,20711
760,Jatitujuh,Majalengka,JawaBarat,117.6091954,87,761,10232,5116,5116
761,Kadipaten,Majalengka,JawaBarat,6177.291667,24,762,148255,74127,74128
762,Kasokandel,Majalengka,JawaBarat,266.9722222,36,763,9611,4805,4806
763,Kertajati,Majalengka,JawaBarat,826.3939394,198,764,163626,81813,81813
764,Lemahsugih,Majalengka,JawaBarat,158.0487805,82,765,12960,6480,6480
765,Majalengka,Majalengka,JawaBarat,133.8,65,766,8697,4348,4349
766,Malausma,Majalengka,JawaBarat,21.89130435,46,767,1007,503,504
767,Panyingkiran,Majalengka,JawaBarat,3490.818182,22,768,76798,38399,38399
768,Babakancikao,Purwakarta,JawaBarat,1954.978723,47,769,91884,45942,45942
769,Bojong,Purwakarta,JawaBarat,160.8227848,79,770,12705,6352,6353
770,Bungursari,Purwakarta,JawaBarat,1277.177778,45,771,57473,28736,28737
771,Campaka,Purwakarta,JawaBarat,864.5689655,58,772,50145,25072,25073
772,Cibatu,Purwakarta,JawaBarat,860.3442623,61,773,52481,26240,26241
773,Darangdan,Purwakarta,JawaBarat,1278.015873,63,774,80515,40257,40258
774,Jatiluhur,Purwakarta,JawaBarat,2246.714286,42,775,94362,47181,47181
775,Kiarapedes,Purwakarta,JawaBarat,79.81666667,60,776,4789,2394,2395
776,Maniis,Purwakarta,JawaBarat,370.7457627,59,777,21874,10937,10937
777,Pasawahan,Purwakarta,JawaBarat,924.1,30,778,27723,13861,13862
778,Plered,Purwakarta,JawaBarat,1661.25,32,779,53160,26580,26580
779,PondokSalam,Purwakarta,JawaBarat,150.1578947,38,780,5706,2853,2853
780,Purwakarta,Purwakarta,JawaBarat,5222.68,25,781,130567,65283,65284
781,Sukasari,Purwakarta,JawaBarat,243.9,90,782,21951,10975,10976
782,Sukatani,Purwakarta,JawaBarat,372.0897436,78,783,29023,14511,14512
783,TegalWaru,Purwakarta,JawaBarat,801.2539683,63,784,50479,25239,25240
784,WadukJatiluhur,Purwakarta,JawaBarat,42.44,75,785,3183,1591,1592
785,Wanayasa,Purwakarta,JawaBarat,237.1272727,55,786,13042,6521,6521
786,Binong,Subang,JawaBarat,1210.436364,55,787,66574,33287,33287
787,Blanakan,Subang,JawaBarat,706.2592593,108,788,76276,38138,38138
788,Ciasem,Subang,JawaBarat,1412.55,100,789,141255,70627,70628
789,Ciater,Subang,JawaBarat,226.96875,64,790,14526,7263,7263
790,Cibogo,Subang,JawaBarat,315.5254237,59,791,18616,9308,9308
791,Cijambe,Subang,JawaBarat,68,95,792,6460,3230,3230
792,Cikaum,Subang,JawaBarat,535.5897436,78,793,41776,20888,20888
793,Cipeundeuy,Subang,JawaBarat,811.2653061,98,794,79504,39752,39752
794,Cipunagara,Subang,JawaBarat,654.037037,108,795,70636,35318,35318
795,Cisalak,Subang,JawaBarat,125.4811321,106,796,13301,6650,6651
796,Compreng,Subang,JawaBarat,988.0277778,72,797,71138,35569,35569
797,Dawuan,Subang,JawaBarat,132.967033,91,798,12100,6050,6050
798,Jalancagak,Subang,JawaBarat,133.2758621,58,799,7730,3865,3865
799,Kalijati,Subang,JawaBarat,267.46,100,800,26746,13373,13373
800,Kasomalang,Subang,JawaBarat,119.2142857,42,801,5007,2503,2504
801,Legonkulon,Subang,JawaBarat,552.5512821,78,802,43099,21549,21550
802,Pabuaran,Subang,JawaBarat,720.8518519,81,803,58389,29194,29195
803,Pagaden,Subang,JawaBarat,1313.6875,48,804,63057,31528,31529
804,PagadenBarat,Subang,JawaBarat,888.1923077,52,805,46186,23093,23093
805,Pamanukan,Subang,JawaBarat,4729.310345,29,806,137150,68575,68575
806,Patokbeusi,Subang,JawaBarat,1096.15534,103,807,112904,56452,56452
807,Purwadadi,Subang,JawaBarat,788.3472222,72,808,56761,28380,28381
808,Pusakajaya,Subang,JawaBarat,1018.901961,51,809,51964,25982,25982
809,Pusakanagara,Subang,JawaBarat,715.516129,62,810,44362,22181,22181
810,Sagalaherang,Subang,JawaBarat,104.3571429,56,811,5844,2922,2922
811,Serangpanjang,Subang,JawaBarat,70.21794872,78,812,5477,2738,2739
812,Subang,Subang,JawaBarat,1891.846154,65,813,122970,61485,61485
813,Sukasari,Subang,JawaBarat,742.6851852,54,814,40105,20052,20053
814,Tambakdahan,Subang,JawaBarat,1336.15625,64,815,85514,42757,42757
815,Tanjungsiang,Subang,JawaBarat,108.0806452,62,816,6701,3350,3351
816,Bantargadung,Sukabumi,JawaBarat,361.8518519,81,817,29310,14655,14655
817,BojongGenteng,Sukabumi,JawaBarat,162.6,15,818,2439,1219,1220
818,Caringin,Sukabumi,JawaBarat,352.7837838,37,819,13053,6526,6527
819,Ciambar,Sukabumi,JawaBarat,145.9272727,55,820,8026,4013,4013
820,Cibadak,Sukabumi,JawaBarat,1241.15,60,821,74469,37234,37235
821,Cibitung,Sukabumi,JawaBarat,568.0813953,86,822,48855,24427,24428
822,Cicantayan,Sukabumi,JawaBarat,414.6857143,35,823,14514,7257,7257
823,Cicurug,Sukabumi,JawaBarat,460.0192308,52,824,23921,11960,11961
824,Cidadap,Sukabumi,JawaBarat,446.9156627,83,825,37094,18547,18547
825,Cidahu,Sukabumi,JawaBarat,154.2222222,36,826,5552,2776,2776
826,Cidolog,Sukabumi,JawaBarat,348.7745098,102,827,35575,17787,17788
827,Ciemas,Sukabumi,JawaBarat,593.7718121,298,828,176944,88472,88472
828,Cikakak,Sukabumi,JawaBarat,73.94915254,118,829,8726,4363,4363
829,Cikembar,Sukabumi,JawaBarat,973.8809524,84,830,81806,40903,40903
830,Cikidang,Sukabumi,JawaBarat,349.8709677,155,831,54230,27115,27115
831,Cimanggu,Sukabumi,JawaBarat,699.7321429,56,832,39185,19592,19593
832,Ciracap,Sukabumi,JawaBarat,747.7051282,156,833,116642,58321,58321
833,Cireunghas,Sukabumi,JawaBarat,338.7058824,34,834,11516,5758,5758
834,Cisaat,Sukabumi,JawaBarat,3110.086957,23,835,71532,35766,35766
835,Cisolok,Sukabumi,JawaBarat,238.4046243,173,836,41244,20622,20622
836,Curugkembar,Sukabumi,JawaBarat,452.2222222,54,837,24420,12210,12210
837,GegerBitung,Sukabumi,JawaBarat,217.7538462,65,838,14154,7077,7077
838,Gunungguruh,Sukabumi,JawaBarat,939.96,25,839,23499,11749,11750
839,JampangKulon,Sukabumi,JawaBarat,1353.338028,71,840,96087,48043,48044
840,JampangTengah,Sukabumi,JawaBarat,829.2032086,187,841,155061,77530,77531
841,Kabandungan,Sukabumi,JawaBarat,47.50714286,140,842,6651,3325,3326
842,Kadudampit,Sukabumi,JawaBarat,196.3188406,69,843,13546,6773,6773
843,KalapaNunggal,Sukabumi,JawaBarat,188.1886792,53,844,9974,4987,4987
844,KaliBunder,Sukabumi,JawaBarat,577.3068182,88,845,50803,25401,25402
845,Kebonpedes,Sukabumi,JawaBarat,1997.75,12,846,23973,11986,11987
846,Lengkong,Sukabumi,JawaBarat,658.3566434,143,847,94145,47072,47073
847,Nagrak,Sukabumi,JawaBarat,273.7297297,74,848,20256,10128,10128
848,Nyalindung,Sukabumi,JawaBarat,347.1121495,107,849,37141,18570,18571
849,Pabuaran,Sukabumi,JawaBarat,703.8034188,117,850,82345,41172,41173
850,ParakanSalak,Sukabumi,JawaBarat,96.86842105,38,851,3681,1840,1841
851,ParungKuda,Sukabumi,JawaBarat,387.3333333,30,852,11620,5810,5810
852,PelabuhanRatu,Sukabumi,JawaBarat,737.5368421,95,853,70066,35033,35033
853,Purabaya,Sukabumi,JawaBarat,595.1571429,140,854,83322,41661,41661
854,Sagaranten,Sukabumi,JawaBarat,937.2743363,113,855,105912,52956,52956
855,Simpenan,Sukabumi,JawaBarat,546.4566474,173,856,94537,47268,47269
856,Sukabumi,Sukabumi,JawaBarat,779.6551724,29,857,22610,11305,11305
857,Sukalarang,Sukabumi,JawaBarat,1449.705882,34,858,49290,24645,24645
858,Sukaraja,Sukabumi,JawaBarat,1052.146341,41,859,43138,21569,21569
859,Surade,Sukabumi,JawaBarat,1105.208333,120,860,132625,66312,66313
860,TegalBuleud,Sukabumi,JawaBarat,563.9885057,261,861,147201,73600,73601
861,Waluran,Sukabumi,JawaBarat,813.4519231,104,862,84599,42299,42300
862,WarungKiara,Sukabumi,JawaBarat,382.9583333,96,863,36764,18382,18382
863,Buahdua,Sumedang,JawaBarat,263.8173913,115,864,30339,15169,15170
864,Cibugel,Sumedang,JawaBarat,462.9038462,52,865,24071,12035,12036
865,Cimalaka,Sumedang,JawaBarat,1250.755556,45,866,56284,28142,28142
866,Cimanggung,Sumedang,JawaBarat,1048.431818,44,867,46131,23065,23066
867,Cisarua,Sumedang,JawaBarat,337.7058824,17,868,5741,2870,2871
868,Cisitu,Sumedang,JawaBarat,339.171875,64,869,21707,10853,10854
869,Conggeang,Sumedang,JawaBarat,474.2314815,108,870,51217,25608,25609
870,Darmaraja,Sumedang,JawaBarat,650.3859649,57,871,37072,18536,18536
871,Ganeas,Sumedang,JawaBarat,197.2,25,872,4930,2465,2465
872,Jatigede,Sumedang,JawaBarat,527.5775862,116,873,61199,30599,30600
873,Jatinangor,Sumedang,JawaBarat,4955.692308,26,874,128848,64424,64424
874,Jatinunggal,Sumedang,JawaBarat,716.8939394,66,875,47315,23657,23658
875,Pamulihan,Sumedang,JawaBarat,826.7592593,54,876,44645,22322,22323
876,Paseh,Sumedang,JawaBarat,1219.444444,36,877,43900,21950,21950
877,Rancakalong,Sumedang,JawaBarat,195.862069,58,878,11360,5680,5680
878,Situraja,Sumedang,JawaBarat,343.254902,51,879,17506,8753,8753
879,Sukasari,Sumedang,JawaBarat,930.3076923,39,880,36282,18141,18141
880,SumedangSelatan,Sumedang,JawaBarat,574.3737374,99,881,56863,28431,28432
881,SumedangUtara,Sumedang,JawaBarat,2294.387097,31,882,71126,35563,35563
882,Surian,Sumedang,JawaBarat,116.9759036,83,883,9709,4854,4855
883,Tanjungkerta,Sumedang,JawaBarat,298.0851064,47,884,14010,7005,7005
884,Tanjungmedar,Sumedang,JawaBarat,126.0882353,68,885,8574,4287,4287
885,Tanjungsari,Sumedang,JawaBarat,2090.466667,45,886,94071,47035,47036
886,Tomo,Sumedang,JawaBarat,2131.819277,83,887,176941,88470,88471
887,UjungJaya,Sumedang,JawaBarat,1102.149425,87,888,95887,47943,47944
888,Wado,Sumedang,JawaBarat,373.6760563,71,889,26531,13265,13266
889,Bantarkalong,Tasikmalaya,JawaBarat,441.9545455,66,890,29169,14584,14585
890,Bojongasih,Tasikmalaya,JawaBarat,514.875,48,891,24714,12357,12357
891,Bojonggambir,Tasikmalaya,JawaBarat,412.5185185,135,892,55690,27845,27845
892,Ciawi,Tasikmalaya,JawaBarat,801.6875,48,893,38481,19240,19241
893,Cibalong,Tasikmalaya,JawaBarat,685,63,894,43155,21577,21578
894,Cigalontang,Tasikmalaya,JawaBarat,414.0890411,146,895,60457,30228,30229
895,Cikalong,Tasikmalaya,JawaBarat,433.5705521,163,896,70672,35336,35336
896,Cikatomas,Tasikmalaya,JawaBarat,60.70469799,149,897,9045,4522,4523
897,Cipatujah,Tasikmalaya,JawaBarat,856.4197531,243,898,208110,104055,104055
898,Cisayong,Tasikmalaya,JawaBarat,477.54,50,899,23877,11938,11939
899,Culamega,Tasikmalaya,JawaBarat,328.4117647,85,900,27915,13957,13958
900,Jamanis,Tasikmalaya,JawaBarat,1170.058824,17,901,19891,9945,9946
901,Jatiwaras,Tasikmalaya,JawaBarat,97.44827586,87,902,8478,4239,4239
902,Kadipaten,Tasikmalaya,JawaBarat,544.4285714,42,903,22866,11433,11433
903,Karangnunggal,Tasikmalaya,JawaBarat,778.4967742,155,904,120667,60333,60334
904,Leuwisari,Tasikmalaya,JawaBarat,1487.875,32,905,47612,23806,23806
905,Mangunreja,Tasikmalaya,JawaBarat,1365.615385,26,906,35506,17753,17753
906,Padakembang,Tasikmalaya,JawaBarat,1448.368421,19,907,27519,13759,13760
907,Pagerageung,Tasikmalaya,JawaBarat,235.5882353,68,908,16020,8010,8010
908,Parungponteng,Tasikmalaya,JawaBarat,659.18,50,909,32959,16479,16480
909,Puspahiang,Tasikmalaya,JawaBarat,504.6885246,61,910,30786,15393,15393
910,Rajapolah,Tasikmalaya,JawaBarat,1591.428571,14,911,22280,11140,11140
911,Salawu,Tasikmalaya,JawaBarat,719.4931507,73,912,52523,26261,26262
912,Sariwangi,Tasikmalaya,JawaBarat,462.1842105,38,913,17563,8781,8782
913,Singaparna,Tasikmalaya,JawaBarat,2180.090909,22,914,47962,23981,23981
914,Sodonghilir,Tasikmalaya,JawaBarat,503.5940594,101,915,50863,25431,25432
915,Sukahening,Tasikmalaya,JawaBarat,196.53125,32,916,6289,3144,3145
916,Sukaraja,Tasikmalaya,JawaBarat,413.62,50,917,20681,10340,10341
917,Sukarame,Tasikmalaya,JawaBarat,1106.8125,16,918,17709,8854,8855
918,Sukaratu,Tasikmalaya,JawaBarat,714.8095238,42,919,30022,15011,15011
919,Sukaresik,Tasikmalaya,JawaBarat,892.7222222,18,920,16069,8034,8035
920,Tanjungjaya,Tasikmalaya,JawaBarat,367.8780488,41,921,15083,7541,7542
921,Taraju,Tasikmalaya,JawaBarat,605.5846154,65,922,39363,19681,19682
922,WadukCirata,WadukCirata,JawaBarat,205.2037037,54,923,11081,5540,5541
923,Lingga,Lingga,KepulauanRiau,39.56228956,594,924,23500,11750,11750
924,LinggaUtara,Lingga,KepulauanRiau,25.87936508,315,925,8152,4076,4076
925,Senayang,Lingga,KepulauanRiau,2.771058315,463,926,1283,641,642
926,Singkep,Lingga,KepulauanRiau,46.54385965,342,927,15918,7959,7959
927,SingkepBarat,Lingga,KepulauanRiau,33.44510978,501,928,16756,8378,8378
928,Kedaton,BandarLampung,Lampung,7921.545455,11,929,87137,43568,43569
929,Kemiling,BandarLampung,Lampung,2150.578947,19,930,40861,20430,20431
930,Panjang,BandarLampung,Lampung,1139.782609,23,931,26215,13107,13108
931,Rajabasa,BandarLampung,Lampung,2964.285714,14,932,41500,20750,20750
932,Sukabumi,BandarLampung,Lampung,5766.333333,9,933,51897,25948,25949
933,Sukarame,BandarLampung,Lampung,4486.133333,15,934,67292,33646,33646
934,TanjungKarangBarat,BandarLampung,Lampung,3399.615385,13,935,44195,22097,22098
935,TanjungKarangPusat,BandarLampung,Lampung,13851.71429,7,936,96962,48481,48481
936,TanjungKarangTimur,BandarLampung,Lampung,2854.277778,18,937,51377,25688,25689
937,TanjungSenang,BandarLampung,Lampung,4247.625,8,938,33981,16990,16991
938,TelukBetungBarat,BandarLampung,Lampung,3610.619048,21,939,75823,37911,37912
939,TelukBetungSelatan,BandarLampung,Lampung,10170.72727,11,940,111878,55939,55939
940,TelukBetungUtara,BandarLampung,Lampung,4570.25,12,941,54843,27421,27422
941,BalikBukit,LampungBarat,Lampung,16.74054054,185,942,3097,1548,1549
942,BatuBrak,LampungBarat,Lampung,2.02166065,277,943,560,280,280
943,Belalau,LampungBarat,Lampung,5.028846154,312,944,1569,784,785
944,Bengkunat,LampungBarat,Lampung,16.05128205,78,945,1252,626,626
945,BengkunatBelimbing,LampungBarat,Lampung,8.811728395,324,946,2855,1427,1428
946,GedungSurian,LampungBarat,Lampung,25.76595745,94,947,2422,1211,1211
947,Hutan,LampungBarat,Lampung,1.697247706,1635,948,2775,1387,1388
948,KaryaPenggawa,LampungBarat,Lampung,17.80952381,84,949,1496,748,748
949,Lemong,LampungBarat,Lampung,7.537572254,173,950,1304,652,652
950,Ngambur,LampungBarat,Lampung,24.77310924,119,951,2948,1474,1474
951,PesisirSelatan,LampungBarat,Lampung,10.50233645,428,952,4495,2247,2248
952,PesisirTengah,LampungBarat,Lampung,30.52631579,114,953,3480,1740,1740
953,PesisirUtara,LampungBarat,Lampung,16.98245614,57,954,968,484,484
954,Sekincau,LampungBarat,Lampung,10.09152542,295,955,2977,1488,1489
955,Sukau,LampungBarat,Lampung,13.19457014,221,956,2916,1458,1458
956,SumberJaya,LampungBarat,Lampung,22.24074074,162,957,3603,1801,1802
957,Suoh,LampungBarat,Lampung,7.665789474,380,958,2913,1456,1457
958,WayTenong,LampungBarat,Lampung,40.37619048,210,959,8479,4239,4240
959,Bakauheni,LampungSelatan,Lampung,115.3521127,71,960,8190,4095,4095
960,Candipuro,LampungSelatan,Lampung,371.2818182,110,961,40841,20420,20421
961,Hutan,LampungSelatan,Lampung,51.27272727,22,962,1128,564,564
962,JatiAgung,LampungSelatan,Lampung,628.4244898,245,963,153964,76982,76982
963,Kalianda,LampungSelatan,Lampung,657.474026,154,964,101251,50625,50626
964,Katibung,LampungSelatan,Lampung,410.4744526,137,965,56235,28117,28118
965,Ketapang,LampungSelatan,Lampung,510.2834646,127,966,64806,32403,32403
966,MerbauMataram,LampungSelatan,Lampung,301.7923077,130,967,39233,19616,19617
967,Natar,LampungSelatan,Lampung,703.4724409,254,968,178682,89341,89341
968,Palas,LampungSelatan,Lampung,322.3838384,99,969,31916,15958,15958
969,Penengahan,LampungSelatan,Lampung,492.3409091,132,970,64989,32494,32495
970,Pulau,LampungSelatan,Lampung,140.52,25,971,3513,1756,1757
971,Rajabasa,LampungSelatan,Lampung,307.9518072,83,972,25560,12780,12780
972,Sidomulyo,LampungSelatan,Lampung,559.9193548,124,973,69430,34715,34715
973,Sragi,LampungSelatan,Lampung,405.0990099,101,974,40915,20457,20458
974,TanjungBintang,LampungSelatan,Lampung,293.1079545,176,975,51587,25793,25794
975,TanjungSari,LampungSelatan,Lampung,849.1397849,93,976,78970,39485,39485
976,WayPanji,LampungSelatan,Lampung,683.4927536,69,977,47161,23580,23581
977,WaySulan,LampungSelatan,Lampung,610.5348837,43,978,26253,13126,13127
978,AnakRatuAji,LampungTengah,Lampung,392.1891892,74,979,29022,14511,14511
979,AnakTuha,LampungTengah,Lampung,324.2903226,155,980,50265,25132,25133
980,BandarMataram,LampungTengah,Lampung,275.3400771,1038,981,285803,142901,142902
981,BandarSurabaya,LampungTengah,Lampung,289.5555556,135,982,39090,19545,19545
982,Bangunrejo,LampungTengah,Lampung,210.295082,122,983,25656,12828,12828
983,Bekri,LampungTengah,Lampung,205.7920792,101,984,20785,10392,10393
984,BumiNabung,LampungTengah,Lampung,443.9230769,104,985,46168,23084,23084
985,BumiRatuNuban,LampungTengah,Lampung,517.530303,66,986,34157,17078,17079
986,GunungSugih,LampungTengah,Lampung,576.3772455,167,987,96255,48127,48128
987,Kalirejo,LampungTengah,Lampung,121.3333333,102,988,12376,6188,6188
988,KotaGajah,LampungTengah,Lampung,453.440678,59,989,26753,13376,13377
989,PadangRatu,LampungTengah,Lampung,355.9719101,178,990,63363,31681,31682
990,Pubian,LampungTengah,Lampung,127.5927835,194,991,24753,12376,12377
991,Punggur,LampungTengah,Lampung,272.15,60,992,16329,8164,8165
992,PutraRumbia,LampungTengah,Lampung,346.3061224,98,993,33938,16969,16969
993,Rumbia,LampungTengah,Lampung,338.920354,113,994,38298,19149,19149
994,SelagaiLingga,LampungTengah,Lampung,58.27777778,324,995,18882,9441,9441
995,SendangAgung,LampungTengah,Lampung,175.3578947,95,996,16659,8329,8330
996,SeputihAgung,LampungTengah,Lampung,306.7019231,104,997,31897,15948,15949
997,SeputihBanyak,LampungTengah,Lampung,283.3488372,129,998,36552,18276,18276
998,SeputihMataram,LampungTengah,Lampung,289.7583333,120,999,34771,17385,17386
999,SeputihRaman,LampungTengah,Lampung,477.7412587,143,1000,68317,34158,34159
1000,SeputihSurabaya,LampungTengah,Lampung,361.8181818,143,1001,51740,25870,25870
1001,TerbanggiBesar,LampungTengah,Lampung,584.410628,207,1002,120973,60486,60487
1002,TerusanNunyai,LampungTengah,Lampung,341.1967213,305,1003,104065,52032,52033
1003,Trimurjo,LampungTengah,Lampung,1023.031746,63,1004,64451,32225,32226
1004,WayPengubuan,LampungTengah,Lampung,347.8653846,208,1005,72356,36178,36178
1005,WaySeputih,LampungTengah,Lampung,376.5322581,62,1006,23345,11672,11673
1006,BandarSribawono,LampungTimur,Lampung,180.6642857,140,1007,25293,12646,12647
1007,Batanghari,LampungTimur,Lampung,781.0761905,105,1008,82013,41006,41007
1008,BatanghariNuban,LampungTimur,Lampung,532.3362069,116,1009,61751,30875,30876
1009,BrajaSlebah,LampungTimur,Lampung,234.8536585,82,1010,19258,9629,9629
1010,BumiAgung,LampungTimur,Lampung,284.515625,64,1011,18209,9104,9105
1011,GunungPelindung,LampungTimur,Lampung,49.45714286,35,1012,1731,865,866
1012,Hutan,LampungTimur,Lampung,113.3972286,1299,1013,147303,73651,73652
1013,Jabung,LampungTimur,Lampung,227.0697674,215,1014,48820,24410,24410
1014,LabuhanMaringgai,LampungTimur,Lampung,174.1205674,141,1015,24551,12275,12276
1015,LabuhanRatu,LampungTimur,Lampung,371.0612245,98,1016,36364,18182,18182
1016,MargaSekapung,LampungTimur,Lampung,240.8392857,112,1017,26974,13487,13487
1017,Margatiga,LampungTimur,Lampung,238.4923077,130,1018,31004,15502,15502
1018,MataramBaru,LampungTimur,Lampung,218.25,48,1019,10476,5238,5238
1019,Melinting,LampungTimur,Lampung,118.9358974,78,1020,9277,4638,4639
1020,MetroKibang,LampungTimur,Lampung,640.8604651,43,1021,27557,13778,13779
1021,PasirSakti,LampungTimur,Lampung,259.6393443,122,1022,31676,15838,15838
1022,Pekalongan,LampungTimur,Lampung,432.1290323,62,1023,26792,13396,13396
1023,Pulau,LampungTimur,Lampung,,0,1024,,0,0
1024,Purbolinggo,LampungTimur,Lampung,277.4507042,71,1025,19699,9849,9850
1025,RamanUtara,LampungTimur,Lampung,250.4361702,94,1026,23541,11770,11771
1026,Sekampung,LampungTimur,Lampung,565.3148148,108,1027,61054,30527,30527
1027,SekampungUdik,LampungTimur,Lampung,181.1688889,225,1028,40763,20381,20382
1028,Sukadana,LampungTimur,Lampung,276.5362903,248,1029,68581,34290,34291
1029,WawayKarya,LampungTimur,Lampung,676.7575758,165,1030,111665,55832,55833
1030,WayBungur,LampungTimur,Lampung,240.3,60,1031,14418,7209,7209
1031,WayJepara,LampungTimur,Lampung,288.9306931,101,1032,29182,14591,14591
1032,AbungBarat,LampungUtara,Lampung,52.46341463,82,1033,4302,2151,2151
1033,AbungKunang,LampungUtara,Lampung,129.2089552,67,1034,8657,4328,4329
1034,AbungPekurun,LampungUtara,Lampung,46.25,184,1035,8510,4255,4255
1035,AbungSelatan,LampungUtara,Lampung,248.95,120,1036,29874,14937,14937
1036,AbungSemuli,LampungUtara,Lampung,269.2058824,102,1037,27459,13729,13730
1037,AbungSurakarta,LampungUtara,Lampung,176.7346939,98,1038,17320,8660,8660
1038,AbungTengah,LampungUtara,Lampung,79.64864865,74,1039,5894,2947,2947
1039,AbungTimur,LampungUtara,Lampung,221.8309859,142,1040,31500,15750,15750
1040,AbungTinggi,LampungUtara,Lampung,23.2173913,69,1041,1602,801,801
1041,BlambanganPagar,LampungUtara,Lampung,250.6914894,94,1042,23565,11782,11783
1042,BukitKemuning,LampungUtara,Lampung,15.8150289,173,1043,2736,1368,1368
1043,BungaMayang,LampungUtara,Lampung,259.3145161,124,1044,32155,16077,16078
1044,Hulusungkai,LampungUtara,Lampung,45.37362637,91,1045,4129,2064,2065
1045,Kotabumi,LampungUtara,Lampung,585.3658537,82,1046,48000,24000,24000
1046,KotabumiSelatan,LampungUtara,Lampung,608.6666667,90,1047,54780,27390,27390
1047,KotabumiUtara,LampungUtara,Lampung,196.4519774,177,1048,34772,17386,17386
1048,MuaraSungkai,LampungUtara,Lampung,269.7862595,131,1049,35342,17671,17671
1049,SungkaiBarat,LampungUtara,Lampung,31.61333333,75,1050,2371,1185,1186
1050,SungkaiJaya,LampungUtara,Lampung,36.32,50,1051,1816,908,908
1051,SungkaiSelatan,LampungUtara,Lampung,121.375,112,1052,13594,6797,6797
1052,SungkaiTengah,LampungUtara,Lampung,41.92771084,83,1053,3480,1740,1740
1053,SungkaiUtara,LampungUtara,Lampung,256.4255319,141,1054,36156,18078,18078
1054,TanjungRaja,LampungUtara,Lampung,20.41232227,211,1055,4307,2153,2154
1055,Hutan,Mesuji,Lampung,73.80128205,156,1056,11513,5756,5757
1056,Mesuji,Mesuji,Lampung,102.5182482,274,1057,28090,14045,14045
1057,MesujiTimur,Mesuji,Lampung,93.16728625,807,1058,75186,37593,37593
1058,PancaJaya,Mesuji,Lampung,197.3968254,63,1059,12436,6218,6218
1059,RawajituUtara,Mesuji,Lampung,113.4598214,224,1060,25415,12707,12708
1060,SimpangPematang,Mesuji,Lampung,203.5602837,141,1061,28702,14351,14351
1061,TanjungRaya,Mesuji,Lampung,162.3896104,231,1062,37512,18756,18756
1062,WaySerdang,Mesuji,Lampung,186.9353741,294,1063,54959,27479,27480
1063,MetroBarat,Metro,Lampung,1875.692308,13,1064,24384,12192,12192
1064,MetroPusat,Metro,Lampung,1949.692308,13,1065,25346,12673,12673
1065,MetroSelatan,Metro,Lampung,1021.333333,18,1066,18384,9192,9192
1066,MetroTimur,Metro,Lampung,2599.5,12,1067,31194,15597,15597
1067,MetroUtara,Metro,Lampung,528.6666667,21,1068,11102,5551,5551
1068,GedungTataan,Pesawaran,Lampung,294.4380952,105,1069,30916,15458,15458
1069,Hutan,Pesawaran,Lampung,52,366,1070,19032,9516,9516
1070,Kedondong,Pesawaran,Lampung,238.4025157,159,1071,37906,18953,18953
1071,NegeriKaton,Pesawaran,Lampung,358.34375,192,1072,68802,34401,34401
1072,PadangCermin,Pesawaran,Lampung,258.1087866,239,1073,61688,30844,30844
1073,PunduhPidada,Pesawaran,Lampung,151.9754098,122,1074,18541,9270,9271
1074,Tegineneng,Pesawaran,Lampung,880.3230769,130,1075,114442,57221,57221
1075,WayLima,Pesawaran,Lampung,232.8412698,63,1076,14669,7334,7335
1076,AdiLuwih,Pringsewu,Lampung,283.9473684,57,1077,16185,8092,8093
1077,Ambarawa,Pringsewu,Lampung,175.8,30,1078,5274,2637,2637
1078,Banyumas,Pringsewu,Lampung,92.25714286,35,1079,3229,1614,1615
1079,GadingRejo,Pringsewu,Lampung,1337.566667,60,1080,80254,40127,40127
1080,Pagelaran,Pringsewu,Lampung,92.88744589,231,1081,21457,10728,10729
1081,Pardasuka,Pringsewu,Lampung,303.6666667,78,1082,23686,11843,11843
1082,Pringsewu,Pringsewu,Lampung,755.0425532,47,1083,35487,17743,17744
1083,Sukoharjo,Pringsewu,Lampung,115.3066667,75,1084,8648,4324,4324
1084,AirNaningan,Tanggamus,Lampung,71.2519084,131,1085,9334,4667,4667
1085,BandarNegeriSemuong,Tanggamus,Lampung,18.63414634,41,1086,764,382,382
1086,Bulok,Tanggamus,Lampung,93.24444444,45,1087,4196,2098,2098
1087,CukuhBalak,Tanggamus,Lampung,90.7133758,157,1088,14242,7121,7121
1088,Gisting,Tanggamus,Lampung,39.24074074,54,1089,2119,1059,1060
1089,GunungAlip,Tanggamus,Lampung,36.9047619,21,1090,775,387,388
1090,Hutan,Tanggamus,Lampung,10.62358277,882,1091,9370,4685,4685
1091,Kelumbayan,Tanggamus,Lampung,80.24576271,118,1092,9469,4734,4735
1092,KelumbayanBarat,Tanggamus,Lampung,25.51546392,97,1093,2475,1237,1238
1093,KotaAgung,Tanggamus,Lampung,338.08,50,1094,16904,8452,8452
1094,KotaAgungBarat,Tanggamus,Lampung,102.097561,41,1095,4186,2093,2093
1095,KotaAgungTimur,Tanggamus,Lampung,141.971831,71,1096,10080,5040,5040
1096,Limau,Tanggamus,Lampung,30.83977901,181,1097,5582,2791,2791
1097,PematangSawa,Tanggamus,Lampung,28.87606838,234,1098,6757,3378,3379
1098,Pugung,Tanggamus,Lampung,33.60621762,193,1099,6486,3243,3243
1099,PulauPanggung,Tanggamus,Lampung,13.4159292,113,1100,1516,758,758
1100,Semaka,Tanggamus,Lampung,24.39473684,114,1101,2781,1390,1391
1101,Sumberejo,Tanggamus,Lampung,12.2962963,54,1102,664,332,332
1102,TalangPadang,Tanggamus,Lampung,24.48275862,29,1103,710,355,355
1103,Ulubelu,Tanggamus,Lampung,85.46853147,143,1104,12222,6111,6111
1104,Wonosobo,Tanggamus,Lampung,57.6,50,1105,2880,1440,1440
1105,GunungAgung,TulangBawangBarat,Lampung,194.72103,233,1106,45370,22685,22685
1106,GunungTerang,TulangBawangBarat,Lampung,177.3313953,172,1107,30501,15250,15251
1107,LambuKibang,TulangBawangBarat,Lampung,221.6283186,113,1108,25044,12522,12522
1108,PagarDewa,TulangBawangBarat,Lampung,238.4797297,148,1109,35295,17647,17648
1109,TulangBawangTengah,TulangBawangBarat,Lampung,284.4761905,252,1110,71688,35844,35844
1110,TulangBawangUdik,TulangBawangBarat,Lampung,288.1255814,215,1111,61947,30973,30974
1111,TumiJajar,TulangBawangBarat,Lampung,182.6068376,117,1112,21365,10682,10683
1112,WayKenanga,TulangBawangBarat,Lampung,239.8,75,1113,17985,8992,8993
1113,BanjarAgung,Tulangbawang,Lampung,254.8913043,92,1114,23450,11725,11725
1114,BanjarBaru,Tulangbawang,Lampung,192.4084507,71,1115,13661,6830,6831
1115,BanjarMargo,Tulangbawang,Lampung,194.1047619,210,1116,40762,20381,20381
1116,DenteTeladas,Tulangbawang,Lampung,103.9632495,517,1117,53749,26874,26875
1117,GedungAji,Tulangbawang,Lampung,123.4255319,94,1118,11602,5801,5801
1118,GedungAjiBaru,Tulangbawang,Lampung,124.3535354,99,1119,12311,6155,6156
1119,GedungMeneng,Tulangbawang,Lampung,155.1390476,1050,1120,162896,81448,81448
1120,Menggala,Tulangbawang,Lampung,272.0902256,133,1121,36188,18094,18094
1121,MenggalaTimur,Tulangbawang,Lampung,225.1941748,103,1122,23195,11597,11598
1122,MeraksaAji,Tulangbawang,Lampung,216.0833333,60,1123,12965,6482,6483
1123,PenawarAji,Tulangbawang,Lampung,192.3451327,113,1124,21735,10867,10868
1124,PenawarTama,Tulangbawang,Lampung,199.7278912,147,1125,29360,14680,14680
1125,RawaPitu,Tulangbawang,Lampung,127.1724138,145,1126,18440,9220,9220
1126,RawajituSelatan,Tulangbawang,Lampung,188.4210526,114,1127,21480,10740,10740
1127,RawajituTimur,Tulangbawang,Lampung,75.59322034,177,1128,13380,6690,6690
1128,Bahuga,WayKanan,Lampung,170.8396226,106,1129,18109,9054,9055
1129,Banjit,WayKanan,Lampung,30.26262626,297,1130,8988,4494,4494
1130,Baradatu,WayKanan,Lampung,139.784,125,1131,17473,8736,8737
1131,BlambanganUmpu,WayKanan,Lampung,100.8019391,722,1132,72779,36389,36390
1132,BuayBahuga,WayKanan,Lampung,131.6865672,67,1133,8823,4411,4412
1133,BumiAgung,WayKanan,Lampung,129.396648,179,1134,23162,11581,11581
1134,GunungLabuhan,WayKanan,Lampung,36.47101449,138,1135,5033,2516,2517
1135,Kasui,WayKanan,Lampung,83.21022727,176,1136,14645,7322,7323
1136,NegaraBatin,WayKanan,Lampung,191.1878049,410,1137,78387,39193,39194
1137,NegeriAgung,WayKanan,Lampung,258.7457627,236,1138,61064,30532,30532
1138,NegeriBesar,WayKanan,Lampung,207.0825688,218,1139,45144,22572,22572
1139,PakuanRatu,WayKanan,Lampung,201.5550162,618,1140,124561,62280,62281
1140,RebangTangkas,WayKanan,Lampung,46.21487603,121,1141,5592,2796,2796
1141,WayTuba,WayKanan,Lampung,150.5025126,199,1142,29950,14975,14975
1142,BatangTuaka,IndragiriHilir,Riau,101.4430693,404,1143,40983,20491,20492
1143,Concong,IndragiriHilir,Riau,66.90566038,265,1144,17730,8865,8865
1144,Enok,IndragiriHilir,Riau,158.8235294,459,1145,72900,36450,36450
1145,Gaung,IndragiriHilir,Riau,31.89356436,2020,1146,64425,32212,32213
1146,GaungAnakSerka,IndragiriHilir,Riau,88.25710015,669,1147,59044,29522,29522
1147,Kateman,IndragiriHilir,Riau,0.950298211,503,1148,478,239,239
1148,Kempas,IndragiriHilir,Riau,41.91023339,557,1149,23344,11672,11672
1149,Kemuning,IndragiriHilir,Riau,20.74663909,967,1150,20062,10031,10031
1150,Keritang,IndragiriHilir,Riau,59.98265306,980,1151,58783,29391,29392
1151,KualaIndragiri,IndragiriHilir,Riau,148.9620787,712,1152,106061,53030,53031
1152,Mandah,IndragiriHilir,Riau,57.21564246,1790,1153,102416,51208,51208
1153,Reteh,IndragiriHilir,Riau,110.8665414,532,1154,58981,29490,29491
1154,SungaiBatang,IndragiriHilir,Riau,102.4034653,404,1155,41371,20685,20686
1155,TanahMerah,IndragiriHilir,Riau,146.8319838,494,1156,72535,36267,36268
1156,Tembilahan,IndragiriHilir,Riau,645.373494,166,1157,107132,53566,53566
1157,TembilahanHulu,IndragiriHilir,Riau,226.1812081,149,1158,33701,16850,16851
1158,Tempuling,IndragiriHilir,Riau,72.3407155,587,1159,42464,21232,21232
1159,BatangCenaku,IndragiriHulu,Riau,27.39476961,803,1160,21998,10999,10999
1160,BatangGansal,IndragiriHulu,Riau,5.888059701,1474,1161,8679,4339,4340
1161,Kelayang,IndragiriHulu,Riau,27.85714286,280,1162,7800,3900,3900
1162,KualaCenaku,IndragiriHulu,Riau,10.08690176,794,1163,8009,4004,4005
1163,Lirik,IndragiriHulu,Riau,29.8358209,335,1164,9995,4997,4998
1164,LubukBatuJaya,IndragiriHulu,Riau,35.11016949,236,1165,8286,4143,4143
1165,PasirPenyu,IndragiriHulu,Riau,217.7642276,123,1166,26785,13392,13393
1166,Peranap,IndragiriHulu,Riau,1.632406288,827,1167,1350,675,675
1167,RakitKulim,IndragiriHulu,Riau,18.9952381,630,1168,11967,5983,5984
1168,Rengat,IndragiriHulu,Riau,39.67094516,857,1169,33998,16999,16999
1169,RengatBarat,IndragiriHulu,Riau,25.06617647,544,1170,13636,6818,6818
1170,Seberida,IndragiriHulu,Riau,57.18244406,581,1171,33223,16611,16612
1171,SungaiLala,IndragiriHulu,Riau,26.19736842,152,1172,3982,1991,1991
1172,BandarPetalangan,Pelalawan,Riau,2.920110193,363,1173,1060,530,530
1173,Kerumutan,Pelalawan,Riau,18.67005076,985,1174,18390,9195,9195
1174,PangkalanKuras,Pelalawan,Riau,0.592682927,1230,1175,729,364,365
1175,PangkalanLesung,Pelalawan,Riau,40.60135135,444,1176,18027,9013,9014
1176,TelukMeranti,Pelalawan,Riau,0.045388701,4142,1177,188,94,94
1177,Ukui,Pelalawan,Riau,16.45576208,1345,1178,22133,11066,11067
1178,AirSalek,BanyuAsin,SumateraSelatan,80.56957929,309,1179,24896,12448,12448
1179,BanyuasinI,BanyuAsin,SumateraSelatan,66.6893039,589,1180,39280,19640,19640
1180,BanyuasinIi,BanyuAsin,SumateraSelatan,14.72208158,3555,1181,52337,26168,26169
1181,BanyuasinIii,BanyuAsin,SumateraSelatan,49.33282905,661,1182,32609,16304,16305
1182,Betung,BanyuAsin,SumateraSelatan,41.22319475,457,1183,18839,9419,9420
1183,MakartiJaya,BanyuAsin,SumateraSelatan,60.76553106,499,1184,30322,15161,15161
1184,MuaraPadang,BanyuAsin,SumateraSelatan,81.25688073,327,1185,26571,13285,13286
1185,MuaraSugihan,BanyuAsin,SumateraSelatan,58.64623244,783,1186,45920,22960,22960
1186,MuaraTelang,BanyuAsin,SumateraSelatan,75.61209068,397,1187,30018,15009,15009
1187,PulauRimau,BanyuAsin,SumateraSelatan,61.41466346,832,1188,51097,25548,25549
1188,Rambutan,BanyuAsin,SumateraSelatan,204.2162162,444,1189,90672,45336,45336
1189,RantauBayur,BanyuAsin,SumateraSelatan,26.32695652,575,1190,15138,7569,7569
1190,TalangKelapa,BanyuAsin,SumateraSelatan,105.1303571,560,1191,58873,29436,29437
1191,TanjungLago,BanyuAsin,SumateraSelatan,40.0863747,822,1192,32951,16475,16476
1192,TungkalIlir,BanyuAsin,SumateraSelatan,38.32089552,402,1193,15405,7702,7703
1193,LintangKanan,EmpatLawang,SumateraSelatan,39.03780069,291,1194,11360,5680,5680
1194,MuaraPinang,EmpatLawang,SumateraSelatan,34.30813953,172,1195,5901,2950,2951
1195,PasmaAirKeruh,EmpatLawang,SumateraSelatan,28.06730769,208,1196,5838,2919,2919
1196,Pendopo,EmpatLawang,SumateraSelatan,73.09967846,311,1197,22734,11367,11367
1197,TalangPadang,EmpatLawang,SumateraSelatan,37.23255814,129,1198,4803,2401,2402
1198,TebingTinggi,EmpatLawang,SumateraSelatan,99.75616438,730,1199,72822,36411,36411
1199,UluMusi,EmpatLawang,SumateraSelatan,45.66549296,568,1200,25938,12969,12969
1200,GumayTalang,Lahat,SumateraSelatan,41.1245283,265,1201,10898,5449,5449
1201,GumayUlu,Lahat,SumateraSelatan,16.82142857,168,1202,2826,1413,1413
1202,Jarai,Lahat,SumateraSelatan,33.43396226,106,1203,3544,1772,1772
1203,KikimBarat,Lahat,SumateraSelatan,520.5533981,206,1204,107234,53617,53617
1204,KikimSelatan,Lahat,SumateraSelatan,65.6875,256,1205,16816,8408,8408
1205,KikimTengah,Lahat,SumateraSelatan,193.8365385,104,1206,20159,10079,10080
1206,KikimTimur,Lahat,SumateraSelatan,104.5781818,550,1207,57518,28759,28759
1207,KotaAgung,Lahat,SumateraSelatan,11.77625571,219,1208,2579,1289,1290
1208,Lahat,Lahat,SumateraSelatan,228.3954545,220,1209,50247,25123,25124
1209,MerapiBarat,Lahat,SumateraSelatan,30.11111111,153,1210,4607,2303,2304
1210,MerapiSelatan,Lahat,SumateraSelatan,10.40540541,111,1211,1155,577,578
1211,MerapiTimur,Lahat,SumateraSelatan,28.19385343,423,1212,11926,5963,5963
1212,MuaraPayang,Lahat,SumateraSelatan,38.93617021,47,1213,1830,915,915
1213,MulakUlu,Lahat,SumateraSelatan,32.63917526,194,1214,6332,3166,3166
1214,PagarGunung,Lahat,SumateraSelatan,13.51181102,127,1215,1716,858,858
1215,PajarBulan,Lahat,SumateraSelatan,77.43902439,205,1216,15875,7937,7938
1216,Pseksu,Lahat,SumateraSelatan,37.00416667,240,1217,8881,4440,4441
1217,PulauPinang,Lahat,SumateraSelatan,19.53333333,120,1218,2344,1172,1172
1218,TanjungSaktiPumi,Lahat,SumateraSelatan,28.1958042,286,1219,8064,4032,4032
1219,TanjungSaktiPumu,Lahat,SumateraSelatan,15.70616114,211,1220,3314,1657,1657
1220,TanjungTebat,Lahat,SumateraSelatan,220.245283,53,1221,11673,5836,5837
1221,LubukLinggauBaratI,Lubuklinggau,SumateraSelatan,359.4385965,57,1222,20488,10244,10244
1222,LubukLinggauBaratIi,Lubuklinggau,SumateraSelatan,3061,8,1223,24488,12244,12244
1223,LubukLinggauSelatanI,Lubuklinggau,SumateraSelatan,127.025,80,1224,10162,5081,5081
1224,LubukLinggauSelatanIi,Lubuklinggau,SumateraSelatan,455.2285714,35,1225,15933,7966,7967
1225,LubukLinggauTimurI,Lubuklinggau,SumateraSelatan,912.9333333,15,1226,13694,6847,6847
1226,LubukLinggauTimurIi,Lubuklinggau,SumateraSelatan,1252.1,10,1227,12521,6260,6261
1227,LubukLinggauUtaraI,Lubuklinggau,SumateraSelatan,25.23880597,134,1228,3382,1691,1691
1228,LubukLinggauUtaraIi,Lubuklinggau,SumateraSelatan,956.78125,32,1229,30617,15308,15309
1229,Abab,MuaraEnim,SumateraSelatan,58.67169811,265,1230,15548,7774,7774
1230,Benakat,MuaraEnim,SumateraSelatan,49.87841191,403,1231,20101,10050,10051
1231,Gelumbang,MuaraEnim,SumateraSelatan,76.8471223,556,1232,42727,21363,21364
1232,GunungMegang,MuaraEnim,SumateraSelatan,41.81597222,576,1233,24086,12043,12043
1233,Kelekar,MuaraEnim,SumateraSelatan,40.01481481,135,1234,5402,2701,2701
1234,LawangKidul,MuaraEnim,SumateraSelatan,161.5252918,257,1235,41512,20756,20756
1235,Lembak,MuaraEnim,SumateraSelatan,71.4,335,1236,23919,11959,11960
1236,Lubai,MuaraEnim,SumateraSelatan,69.58943089,984,1237,68476,34238,34238
1237,MuaraBelida,MuaraEnim,SumateraSelatan,32.05369128,149,1238,4776,2388,2388
1238,MuaraEnim,MuaraEnim,SumateraSelatan,363.8911565,147,1239,53492,26746,26746
1239,Penukal,MuaraEnim,SumateraSelatan,61,354,1240,21594,10797,10797
1240,PenukalUtara,MuaraEnim,SumateraSelatan,54.37313433,335,1241,18215,9107,9108
1241,Rambang,MuaraEnim,SumateraSelatan,28.46130031,323,1242,9193,4596,4597
1242,RambangDangku,MuaraEnim,SumateraSelatan,45.73881674,693,1243,31697,15848,15849
1243,SemendoDaratLaut,MuaraEnim,SumateraSelatan,21.26359833,239,1244,5082,2541,2541
1244,SemendoDaratTengah,MuaraEnim,SumateraSelatan,5.307053942,241,1245,1279,639,640
1245,SemendoDaratUlu,MuaraEnim,SumateraSelatan,12.8185941,441,1246,5653,2826,2827
1246,SungaiRotan,MuaraEnim,SumateraSelatan,43.13945578,294,1247,12683,6341,6342
1247,TalangUbi,MuaraEnim,SumateraSelatan,146.1377899,733,1248,107119,53559,53560
1248,TanahAbang,MuaraEnim,SumateraSelatan,349.7281553,206,1249,72044,36022,36022
1249,TanjungAgung,MuaraEnim,SumateraSelatan,31.43243243,666,1250,20934,10467,10467
1250,UjanMas,MuaraEnim,SumateraSelatan,35.52554745,274,1251,9734,4867,4867
1251,BabatToman,MusiBanyuasin,SumateraSelatan,74.64276402,767,1252,57251,28625,28626
1252,BatanghariLeko,MusiBanyuasin,SumateraSelatan,18.21682567,2306,1253,42008,21004,21004
1253,BayungLencir,MusiBanyuasin,SumateraSelatan,26.84623235,5879,1254,157829,78914,78915
1254,Keluang,MusiBanyuasin,SumateraSelatan,58.80851064,517,1255,30404,15202,15202
1255,Lais,MusiBanyuasin,SumateraSelatan,38.1005291,567,1256,21603,10801,10802
1256,Lalan,MusiBanyuasin,SumateraSelatan,27.76801267,1263,1257,35071,17535,17536
1257,PlakatTinggi,MusiBanyuasin,SumateraSelatan,37.35458167,502,1258,18752,9376,9376
1258,SangaDesa,MusiBanyuasin,SumateraSelatan,51.74835526,608,1259,31463,15731,15732
1259,Sekayu,MusiBanyuasin,SumateraSelatan,75.80108254,739,1260,56017,28008,28009
1260,SungaiKeruh,MusiBanyuasin,SumateraSelatan,34.96717172,792,1261,27694,13847,13847
1261,SungaiLilin,MusiBanyuasin,SumateraSelatan,88.32224532,962,1262,84966,42483,42483
1262,BulanTengahSukuUlu,MusiRawas,SumateraSelatan,296.4358323,787,1263,233295,116647,116648
1263,JayaLoka,MusiRawas,SumateraSelatan,127.3935484,155,1264,19746,9873,9873
1264,KarangDapo,MusiRawas,SumateraSelatan,27.01333333,525,1265,14182,7091,7091
1265,KarangJaya,MusiRawas,SumateraSelatan,16.90261115,1417,1266,23951,11975,11976
1266,MegangSakti,MusiRawas,SumateraSelatan,59.275,440,1267,26081,13040,13041
1267,MuaraBeliti,MusiRawas,SumateraSelatan,101.0287356,174,1268,17579,8789,8790
1268,MuaraKelingi,MusiRawas,SumateraSelatan,63.37634409,744,1269,47152,23576,23576
1269,MuaraLakitan,MusiRawas,SumateraSelatan,26.69967532,1848,1270,49341,24670,24671
1270,Nibung,MusiRawas,SumateraSelatan,45.07248764,607,1271,27359,13679,13680
1271,Purwodadi,MusiRawas,SumateraSelatan,62.37254902,51,1272,3181,1590,1591
1272,RawasIlir,MusiRawas,SumateraSelatan,53.42941757,1013,1273,54124,27062,27062
1273,RawasUlu,MusiRawas,SumateraSelatan,43.72651357,479,1274,20945,10472,10473
1274,Rupit,MusiRawas,SumateraSelatan,31.75452196,387,1275,12289,6144,6145
1275,Selangit,MusiRawas,SumateraSelatan,16.19197708,698,1276,11302,5651,5651
1276,SukaKarya,MusiRawas,SumateraSelatan,339.2936508,126,1277,42751,21375,21376
1277,SukuTengahLakitanUlu,MusiRawas,SumateraSelatan,18.65482234,591,1278,11025,5512,5513
1278,SumberHarta,MusiRawas,SumateraSelatan,41.85454545,110,1279,4604,2302,2302
1279,TiangPumpungKepungut,MusiRawas,SumateraSelatan,171.8291925,322,1280,55329,27664,27665
1280,TuahNegeri,MusiRawas,SumateraSelatan,80.2490566,265,1281,21266,10633,10633
1281,TuguMulyo,MusiRawas,SumateraSelatan,345.5333333,60,1282,20732,10366,10366
1282,UluRawas,MusiRawas,SumateraSelatan,3.467630854,1452,1283,5035,2517,2518
1283,Indralaya,OganIlir,SumateraSelatan,288.0952381,84,1284,24200,12100,12100
1284,IndralayaSelatan,OganIlir,SumateraSelatan,198.1842105,38,1285,7531,3765,3766
1285,IndralayaUtara,OganIlir,SumateraSelatan,125.0348837,344,1286,43012,21506,21506
1286,Kandis,OganIlir,SumateraSelatan,163.3225806,31,1287,5063,2531,2532
1287,LubukKeliat,OganIlir,SumateraSelatan,38.57142857,182,1288,7020,3510,3510
1288,MuaraKuang,OganIlir,SumateraSelatan,45.26712329,292,1289,13218,6609,6609
1289,Payaraman,OganIlir,SumateraSelatan,7.430939227,181,1290,1345,672,673
1290,Pemulutan,OganIlir,SumateraSelatan,364.6470588,119,1291,43393,21696,21697
1291,PemulutanBarat,OganIlir,SumateraSelatan,172.859375,64,1292,11063,5531,5532
1292,PemulutanSelatan,OganIlir,SumateraSelatan,192.4736842,57,1293,10971,5485,5486
1293,RambangKuang,OganIlir,SumateraSelatan,37.90316206,506,1294,19179,9589,9590
1294,RantauAlai,OganIlir,SumateraSelatan,86.81578947,76,1295,6598,3299,3299
1295,RantauPanjang,OganIlir,SumateraSelatan,126.88,50,1296,6344,3172,3172
1296,SungaiPinang,OganIlir,SumateraSelatan,325.5517241,29,1297,9441,4720,4721
1297,TanjungBatu,OganIlir,SumateraSelatan,32.34163701,281,1298,9088,4544,4544
1298,TanjungRaja,OganIlir,SumateraSelatan,338.2972973,74,1299,25034,12517,12517
1299,AirSugihan,OganKomeringIlir,SumateraSelatan,35.07565902,2921,1300,102456,51228,51228
1300,Cengal,OganKomeringIlir,SumateraSelatan,30.709665,2597,1301,79753,39876,39877
1301,Jejawi,OganKomeringIlir,SumateraSelatan,134.2325581,215,1302,28860,14430,14430
1302,KotaKayuAgung,OganKomeringIlir,SumateraSelatan,375.0601504,133,1303,49883,24941,24942
1303,Lempuing,OganKomeringIlir,SumateraSelatan,272.742671,307,1304,83732,41866,41866
1304,LempuingJaya,OganKomeringIlir,SumateraSelatan,213.6485356,478,1305,102124,51062,51062
1305,Mesuji,OganKomeringIlir,SumateraSelatan,91.74396135,621,1306,56973,28486,28487
1306,MesujiMakmur,OganKomeringIlir,SumateraSelatan,154.8019417,515,1307,79723,39861,39862
1307,MesujiRaya,OganKomeringIlir,SumateraSelatan,92.24609375,512,1308,47230,23615,23615
1308,Pampangan,OganKomeringIlir,SumateraSelatan,65.65238095,420,1309,27574,13787,13787
1309,PangkalanLapam,OganKomeringIlir,SumateraSelatan,34.92429792,819,1310,28603,14301,14302
1310,Pedamaran,OganKomeringIlir,SumateraSelatan,98.46666667,615,1311,60557,30278,30279
1311,PedamaranTimur,OganKomeringIlir,SumateraSelatan,43.99231754,781,1312,34358,17179,17179
1312,SirahPulauPadang,OganKomeringIlir,SumateraSelatan,231.9552239,134,1313,31082,15541,15541
1313,SungaiMenang,OganKomeringIlir,SumateraSelatan,48.60038986,2052,1314,99728,49864,49864
1314,TanjungLubuk,OganKomeringIlir,SumateraSelatan,120.5642202,218,1315,26283,13141,13142
1315,TelukGelam,OganKomeringIlir,SumateraSelatan,217.9710983,173,1316,37709,18854,18855
1316,TulungSelapan,OganKomeringIlir,SumateraSelatan,21.86495317,4591,1317,100382,50191,50191
1317,BatuRajaBarat,OganKomeringUlu,SumateraSelatan,164.71,100,1318,16471,8235,8236
1318,BatuRajaTimur,OganKomeringUlu,SumateraSelatan,627.920904,177,1319,111142,55571,55571
1319,Lengkiti,OganKomeringUlu,SumateraSelatan,25.58710407,884,1320,22619,11309,11310
1320,LubukBatang,OganKomeringUlu,SumateraSelatan,74.37410072,556,1321,41352,20676,20676
1321,LubukRaja,OganKomeringUlu,SumateraSelatan,323.432,125,1322,40429,20214,20215
1322,MuaraJaya,OganKomeringUlu,SumateraSelatan,13.58483755,277,1323,3763,1881,1882
1323,Pengandonan,OganKomeringUlu,SumateraSelatan,41.57142857,140,1324,5820,2910,2910
1324,Peninjauan,OganKomeringUlu,SumateraSelatan,180.6099426,523,1325,94459,47229,47230
1325,SemidangAji,OganKomeringUlu,SumateraSelatan,44.66519824,454,1326,20278,10139,10139
1326,SinarPeninjauan,OganKomeringUlu,SumateraSelatan,72.81280788,203,1327,14781,7390,7391
1327,SosohBuayRayap,OganKomeringUlu,SumateraSelatan,43.77027027,222,1328,9717,4858,4859
1328,UluOgan,OganKomeringUlu,SumateraSelatan,15.33744856,243,1329,3727,1863,1864
1329,BandingAgung,OganKomeringUluSelatan,SumateraSelatan,17.88010204,392,1330,7009,3504,3505
1330,BuanaPemaca,OganKomeringUluSelatan,SumateraSelatan,13.54285714,280,1331,3792,1896,1896
1331,BuayPemaca,OganKomeringUluSelatan,SumateraSelatan,17.1516129,620,1332,10634,5317,5317
1332,BuayPematangRibuRanau,OganKomeringUluSelatan,SumateraSelatan,21.71428571,217,1333,4712,2356,2356
1333,BuayRawan,OganKomeringUluSelatan,SumateraSelatan,12.11486486,148,1334,1793,896,897
1334,BuayRunjung,OganKomeringUluSelatan,SumateraSelatan,12.13138686,137,1335,1662,831,831
1335,BuaySandangAji,OganKomeringUluSelatan,SumateraSelatan,15.23809524,168,1336,2560,1280,1280
1336,KisamIlir,OganKomeringUluSelatan,SumateraSelatan,32.51219512,41,1337,1333,666,667
1337,KisamTinggi,OganKomeringUluSelatan,SumateraSelatan,32.48184818,303,1338,9842,4921,4921
1338,MekakauIlir,OganKomeringUluSelatan,SumateraSelatan,9.363839286,448,1339,4195,2097,2098
1339,Muaradua,OganKomeringUluSelatan,SumateraSelatan,28.16949153,236,1340,6648,3324,3324
1340,MuaraduaKisam,OganKomeringUluSelatan,SumateraSelatan,18.8115942,207,1341,3894,1947,1947
1341,PulauBeringin,OganKomeringUluSelatan,SumateraSelatan,10.60153257,261,1342,2767,1383,1384
1342,RunjungAgung,OganKomeringUluSelatan,SumateraSelatan,50.93617021,94,1343,4788,2394,2394
1343,Simpang,OganKomeringUluSelatan,SumateraSelatan,77.88679245,53,1344,4128,2064,2064
1344,SindangDanau,OganKomeringUluSelatan,SumateraSelatan,4.496240602,266,1345,1196,598,598
1345,SungaiAre,OganKomeringUluSelatan,SumateraSelatan,17.46470588,170,1346,2969,1484,1485
1346,TigaDihaji,OganKomeringUluSelatan,SumateraSelatan,11.76969697,165,1347,1942,971,971
1347,WarkukRanauSelatan,OganKomeringUluSelatan,SumateraSelatan,33.73090909,275,1348,9276,4638,4638
1348,Belitang,OganKomeringUluTimur,SumateraSelatan,293.5652174,69,1349,20256,10128,10128
1349,BelitangIi,OganKomeringUluTimur,SumateraSelatan,195.865,200,1350,39173,19586,19587
1350,BelitangIii,OganKomeringUluTimur,SumateraSelatan,201.4964539,141,1351,28411,14205,14206
1351,BelitangJaya,OganKomeringUluTimur,SumateraSelatan,145.5423729,118,1352,17174,8587,8587
1352,BelitangMadangRaya,OganKomeringUluTimur,SumateraSelatan,159.3859649,114,1353,18170,9085,9085
1353,BelitangMulya,OganKomeringUluTimur,SumateraSelatan,369.2222222,36,1354,13292,6646,6646
1354,BuayMadang,OganKomeringUluTimur,SumateraSelatan,191.8554217,83,1355,15924,7962,7962
1355,BuayMadangTimur,OganKomeringUluTimur,SumateraSelatan,155.9097222,144,1356,22451,11225,11226
1356,BuayPemukaBangsaRaja,OganKomeringUluTimur,SumateraSelatan,148.8613861,101,1357,15035,7517,7518
1357,BuayPemukaPeliung,OganKomeringUluTimur,SumateraSelatan,274.9761905,168,1358,46196,23098,23098
1358,BungaMayang,OganKomeringUluTimur,SumateraSelatan,43.03296703,182,1359,7832,3916,3916
1359,Cempaka,OganKomeringUluTimur,SumateraSelatan,99.46898263,403,1360,40086,20043,20043
1360,JayaPura,OganKomeringUluTimur,SumateraSelatan,44.19753086,162,1361,7160,3580,3580
1361,MadangSukuI,OganKomeringUluTimur,SumateraSelatan,181.661157,242,1362,43962,21981,21981
1362,MadangSukuIi,OganKomeringUluTimur,SumateraSelatan,181.1666667,174,1363,31523,15761,15762
1363,MadangSukuIii,OganKomeringUluTimur,SumateraSelatan,260.3684211,228,1364,59364,29682,29682
1364,Martapura,OganKomeringUluTimur,SumateraSelatan,252.4334975,203,1365,51244,25622,25622
1365,SemendawaiBarat,OganKomeringUluTimur,SumateraSelatan,108.1836735,294,1366,31806,15903,15903
1366,SemendawaiSukuIii,OganKomeringUluTimur,SumateraSelatan,154.4409091,220,1367,33977,16988,16989
1367,SemendawaiTimur,OganKomeringUluTimur,SumateraSelatan,119.7412587,143,1368,17123,8561,8562
1368,DempoSelatan,PagarAlam,SumateraSelatan,7.721698113,212,1369,1637,818,819
1369,DempoTengah,PagarAlam,SumateraSelatan,17,189,1370,3213,1606,1607
1370,DempoUtara,PagarAlam,SumateraSelatan,45.23300971,103,1371,4659,2329,2330
1371,PagarAlamSelatan,PagarAlam,SumateraSelatan,169.5333333,45,1372,7629,3814,3815
1372,PagarAlamUtara,PagarAlam,SumateraSelatan,539.3125,48,1373,25887,12943,12944
1373,AlangAlangLebar,Palembang,SumateraSelatan,3396.148148,27,1374,91696,45848,45848
1374,BukitKecil,Palembang,SumateraSelatan,30754,2,1375,61508,30754,30754
1375,Gandus,Palembang,SumateraSelatan,962.9411765,51,1376,49110,24555,24555
1376,IlirBaratI,Palembang,SumateraSelatan,2241.410714,56,1377,125519,62759,62760
1377,IlirBaratIi,Palembang,SumateraSelatan,24725.2,5,1378,123626,61813,61813
1378,IlirTimurI,Palembang,SumateraSelatan,18876,5,1379,94380,47190,47190
1379,IlirTimurIi,Palembang,SumateraSelatan,9814.235294,17,1380,166842,83421,83421
1380,Kalidoni,Palembang,SumateraSelatan,2062.103448,29,1381,59801,29900,29901
1381,Kemuning,Palembang,SumateraSelatan,10254.14286,7,1382,71779,35889,35890
1382,Kertapati,Palembang,SumateraSelatan,1342.555556,45,1383,60415,30207,30208
1383,Plaju,Palembang,SumateraSelatan,13483.4375,16,1384,215735,107867,107868
1384,Sako,Palembang,SumateraSelatan,5488.083333,12,1385,65857,32928,32929
1385,SeberangUluI,Palembang,SumateraSelatan,12099.42857,14,1386,169392,84696,84696
1386,SeberangUluIi,Palembang,SumateraSelatan,12983.90909,11,1387,142823,71411,71412
1387,SematangBorang,Palembang,SumateraSelatan,1690.857143,14,1388,23672,11836,11836
1388,Sukarami,Palembang,SumateraSelatan,2710.38,50,1389,135519,67759,67760
1389,Cambai,Prabumulih,SumateraSelatan,94.64912281,57,1390,5395,2697,2698
1390,PrabumulihBarat,Prabumulih,SumateraSelatan,241.0784314,102,1391,24590,12295,12295
1391,PrabumulihSelatan,Prabumulih,SumateraSelatan,178.3773585,53,1392,9454,4727,4727
1392,PrabumulihTimur,Prabumulih,SumateraSelatan,442.3030303,66,1393,29192,14596,14596
1393,PrabumulihUtara,Prabumulih,SumateraSelatan,1277.642857,14,1394,17887,8943,8944
1394,RambangKapakTengah,Prabumulih,SumateraSelatan,32.63559322,118,1395,3851,1925,1926
